#Cambridge Latin, 3rd Edition, Book 2
@Stage 13
advenio	advenio
aedificium	aedificium
aeger	aeger
alter	alter
canto	canto
ceteri	ceterus
coniuratio	conjuratio
custos	custos
decido	decido#1
dico	dico#2
excito	excito
fessus	fessus
gemini	geminus
haurio	haurio
horreum	horreum#1
interficio	interficio
nolo	nolo
novus	novus
nullus	nullus
numero	numero#1	
ordo	ordo
possum	possum
retineo	retineo
ruo	ruo
se	sui
suaviters	suavis
traho	traho
volo	volo#1	
vulnero	vulnero
@Stage 14
antiquus	antiquus
apud	apud
argenteus	argenteus#1
attonitus	attono
aula	aula#1
cotidie	cottidie
decorus	decorus
deleo	deleo
deus	deus
dicto	dicto	
difficilis	difficilis
diligenter	diligenter
domina	domina
donum	donum
familiaris	familiaris
fidelis	fidelis
ipse	ipse
iste	iste
lavo	lavo
maritus	maritus#1
necesse	necesse
nobilis	nobilis
num	num	
pretiosus	pretiosus
quam	quam	
quamquam	quamquam
rex	rex
sella	sella
ubi	ubi
@Stage 15
agmen	agmen
alius	alius#2
aqua	aqua
claudo	claudo#1
commodus	commodus#1
debeo	debeo
effigies	effigies
equus	equus#1
etiam	etiam
fossa	fossa
fractus	frango
honoro	honoro	
impedio	impedio
lectus	lectus#2	
lente	lentus
litus	litus#3
miser	miser
nauta	nauta
plaustrum	plaustrum
praesum	praesum
princeps	princeps
prior	prior
qui	qui#1	
redeo	redeo
sacerdos	sacerdos#1
saxum	saxum
teneo	teneo
unda	unda	
victor	victor#1
vinco	vinco
@Stage 16
aedificio	aedificium
auxilium	auxilium
bonus	bonus
consentio	consentio
consilium	consilium
deinde	deinde
delecto	delecto	
derideo	derideo
effugio	effugio	
faber	faber#1	
flos	
frumentum	
imperator	imperator
inter	inter
ita	ita	
melior	bonus
navigo	navigo
nonne	nonne	
paratus	paro#1	
pereo	pereo
pono	pono
postridie	postridie
punio	punior
salto	
simulac	
summus	superus
supersum	supersum
tollo	tollo
verto	verto
@Stage 17
ab	ab
animus	animus
appropinquo	appropinquo
ara	ara	
bene	bene
benignus	benignus
desilio	
despero	despero
diu	diu
exanimatus	exanimo
facilis	facilis
fulgeo	fulgeo
gemma	gemma	
graviter	gravis
haereo	haereo
hasta	hasta
huc	huc
impetus	impetus
insula	insula#1
itaque	ita
latro	latro#3
mare	mare
maximus	magnus#1	
multitudo	multitudo
negotium	negotium
numquam	numquam
pauci	paucus
pervenio	pervenio
quondam	
recipio	recipio
sine	sine	
soleo	soleo
sordidus	sordidus
tergum	tergum
vita	vita	
@Stage 18
aliquid	aliquis
audeo	audeo
caput	caput
coepi	coepio
cognisco	
consisto	consisto
dea	dea
demonstro	demonstro
discedo	discedo
fortasse	fortasse
fortuna	fortuna	
frango	frango
ibi	ibi
invitus	invitus
libenter	libet
longus	longus
manus	manus#1
miles	miles	
nam	nam
nemo	nemo
nox	nox
obsto	obsto
pars	pars
periculosus	periculosus
peto	peto
postea	postea
postremo	posterus
praesidium	praesidium
pro	pro#1	
procumbo	procumbo
quo	quo
recuso	recuso
resisto	resisto
sacer	sacer
saevio	saevio
@Stage 19
amo	amo
caedo	caedo
carus	carus#1
castigo	castigo
caute	caveo
cogito	cogito	
comparo	comparo#2
conficio	conficio
curo	curo
de	de#2
defendo	defendo
dulcis	dulcis
filia	filia
fluo	fluo
forte	fors	
illuc	illic
iter	iter	
locus	locus
mane	mane
neglegens	neglego
novi	nosco	
periculum	periculum
plurimus	multus
pompa	pompa
posco	posco
sonitus	sonitus
stola	stola
tot	tot
umerus	umerus
vexo	vexo
vivo	vivo
vix	vix
vox	vox
@Stage 20
adeo	adeo#1	
arcesso	arcesso
ars	ars
auris	auris	
colloco	colloco
crudelis	crudelis
denique	denique
doctus	doceo
domus	domus
equito	equito
hiems	hiems
infero	infero	
irrumpo	irrumpo
latus	latus#1	
libero	libero
luna	luna#1	
medicus	medicus#1
mors	mors
oculus	oculus
parens	parens#2	
persuadeo	persuadeo
pessimus	malus
preces	prex
relinquo	relinquo
remedium	remedium
sermo	sermo
sicut	sicut
tam	tam
tempto	tento
vulnus	vulnus
unus	unus
duo	duo
tres	tres
quattuor	quattuor
quinque	quin
sex	sex
septem	septem
octo	octo
novem	novo
decem	decem
viginti	viginti
traginta	
quadraginta	quadraginta
quinquaginta	quinquaginta
