#Cambridge Latin, 3rd Edition, Book 1
@Stage 1
atrium	atrium
canis	canis#1	
coquus	coquus
est	sum#1
filius	filius
hortus	hortus
in	in
laborat	laboro
mater	mater
pater	pater
sedet	sedeo	
servus	servus#2
via	via	
@Stage 2
amicus	amicus#2
ancilla	ancilla
cena	cena	
cibus	cibus
dominus	dominus
dormit	dormio
gustat	gusto
intrat	intro#2
laetus	laetus#1
laudat	laudo
mensa	mensa
mercator	mercator
quoque	quo
salutat	saluto
@Stage 3
ad	ad
bibit	bibo#1
circumspectat	circumspecto
clamat	clamo
ecce	ecce
et	et
exit	exeo
exspectat	exspecto
forum	forum#1	
ianua	ianua
iratus	irascor
leo	leo#2
magnus	magnus#1
navis	navis	
non	non
portat	porto
respondet	respondeo
ridet	rideo
salve	salveo	
surgit	surgo
taberna	taberna
videt	video
villa	villa	
vinum	vinum	
@Stage 4
agit	ago
anulus	anulus#1
cera	cera	
coquit	coquo
cur	cur
ex	ex
ego	ego
eheu	eheu
habet	habeo
inquit	inquam
iudex	judex
mendax	mendax
pecunia	pecunia
perterritus	perterreo
poeta	poeta	
quaerit	quaero
qui	qui#1	
reddit	reddo
satis	satis
sed	sed
signum	signum
tu	tu
vendit	vendo
vocat	voco
@Stage 5
adest	adsum
agricola	agricola#1
ambulat	ambulo
audit	audio
clamor	clamor
contendit	contendo
currit	curro
euge	euge
fabula	fabula#1
femina	femina	
hodie	hodie
iuvenis	juvenis
meus	meus
multus	multus
optimus	bonus
petit	peto
plaudit	plaudo
puella	puella
senex	senex
spectat	specto
stat	sto
turba	turba	
ubi	ubi
urbs	urbs
venit	venio
@Stage 6
abest	absum
avarus	avarus
cubiculum	cubiculum
emit	emo	
erat	sum#1
ferociter	ferociter
festinat	festino
fortis	fortis
fur	fur
infans	infer
intente	intendo	
libertus	libertus
olim	olim
parvus	parvus
per	per
postquam	postquam
pulsat	pulso
quod	qui#1	
res	res
scribit	scribo
subito	subeo	
superat	supero
tum	tum
tuus	tuus
vituperat	vitupero#1
@Stage 7
cenat	ceno
centurio	centurio#2
conspicit	conspicio#1
cum	cum
facit	facio
heri	heri
ingens	ingens
intellegit	intellego
lacrimat	lacrimo
mortuus	morior	
narrat	narro
necat	neco
nihil	nihil
omnis	omnis
parat	paro#1	
pestis	pestis
poculum	poculum
procedit	procedo
prope	prope
pulcher	pulcher#1
rogat	rogo
tacite	taceo	
tamen	tamen
terret	terreo
umbra	umbra	
valde	validus
@Stage 8
agitat	agito
consumit	consumo
ducit	duco
eum	is
facile	facilis
ferox	ferox
gladius	gladius
habitat	habito
hic	hic
ignavus	ignavus
incitat	incito
nuntius	nuntius
pes	pes
porta	porta	
postulat	postulo
puer	puer
pugnat	pugno
recumbit	recumbo
saepe	saepe	
sanguis	sanguis
silva	silva
spectaculum	spectaculum
statim	statim
totus	totus#1	
tuba	tuba
venatio	venatio
@Stage 9
agnoscit	agnosco
celebrat	celebro
celeriter	celeriter
civis	civis
cupit	cupio
dat	do#1	
dies	dies
emittit	emitto
exercet	exerceo
fert	fero
homo	homo
hospes	hospes
ille	ille
inspicit	inspicio
iterum	iterum
manet	maneo	
medius	medius
mox	mox
notus	nosco	
offert	offertor
ostendit	ostendo
paulisper	paulisper
post	post
revenit	revenio
suus	suus
tradit	trado
@Stage 10
abit	abeo
accipit	accipio
callidus	callidus
capit	capio	capio#1
contentus	contendo	
exclamat	exclamo
frater	frater
hercle	Hercules
imperium	imperium
inimicus	inimicus
invenit	
it	eo#1
liber	liber#4	
nos	nos	
nuntiat	nuntio
pax	pax
portus	portus
quam	quam	
semper	semper
sententia	sententia
servat	servo
solus	solus#1
tacet	taceo
uxor	uxor
vehementer	vehementer
vos	tu	
@Stage 11
convenit	convenio
credit	credo
de	de#2
favet	faveo
gens	gens
invitat	invito
legit	lego#2
liberalis	liberalis#1
minime	parvus
murus	murus
noster	noster
nunc	nunc
placet	placeo	
primus	primus
promittit	promitto
pugna	pugna	
rapit	rapio
secundus	secundus#1
senator	senator
sollicitus	sollicitus
stultus	stultus
tertius	tertius
utilis	utilis
vale	valeo
verberat	verbero#1
vir	vir
@Stage 12
amittit	amitto
cinis	cinis
complet	compleo
custodit	custodio
densus	densus
epistula	epistula
flamma	flamma#1	
fortiter	fortis	
frustra	frustra	
fugit	fugio
fundus	fundus
iacet	jaceo
iam	jam
igitur	igitur
incidit	incido#1	
mirabilis	mirabilis
mittit	mitto
mons	mons
nubes	nubes	
optime	bonus
paene	paene
sentit	sentio
tandem	tandem
templum	templum
terra	terra
timet	timeo
