#Frist Year Latin 1962 Jenney, Charles 1962
@Section 1
agricola	agricola#1
aqua	aqua
femina	femina	
Gallia	Gallia	
littera	littera
natura	natura
poeta	poeta
provincia	provincia
puella	puella
silva	silva
vita	vita	
est	sum#1
sunt	sum#1
@Section 2
amo	amo
laudo	laudo
occupo	occupo
paro	paro#1	
porto	porto
pugno	pugno
specto	specto
voco	voco
@Section 3
amicitia	amicitia
dea	dea
filia	filia
fortuna	fortuna	
lingua	lingua
memoria	memoria
patria	patrius#1
terra	terra
tuba	tuba
via	via	
Italia	Italia
Roma	Roma
non	non
@Section 4
insula	insula#1
nauta	nauta
porta	porta	
villa	villa	
Europa	Europa	
Germania	Germania
Hispania	Hispania
do	do#1
navigo	navigo
sed	sed
et	et
-que	
@Section 5
@Section 6
ager	ager
amicus	amicus#2
annus	annus
campus	campus#2
equus	equus#1
legatus	lego#1
ludus	ludus
puer	puer
servus	servus#2
vir	vir
@Section 7
ab	ab
ad	ad
ante	ante
cum	cum
de	de#2
ex	ex
in	in
per	per
post	post
sub	sub
trans	trans
@Section 8
bellum	bellum	
caelum	caelum#2
donum	donum
frumentum	frumentum
oppidum	oppidum
periculum	periculum
regnum	regnum
verbum	verbum
deus	deus
filius	filius
gladius	gladius
nuntius	nuntius
@Section 9
altus	altus#1	
bonus	bonus
latus	latus#1	
longus	longus
magnus	magnus#1
malus	malus#1	
meus	meus
multus	multus
parvus	parvus
tuus	tuus
@Section 10
@Section 11
appello	appello#1
convoco	convoco
exspecto	exspecto
habito	habito
laboro	laboro
narro	narro
nuntio	nuntio	
supero	supero	
vulnero	vulnero
@Section 12
liber	liber	liber#1	liber#2	liber#4	libo#1
miser	miser
noster	noster
pulcher	pulcher#1
sacer	sacer
vester	vester
contra	contra
inter	inter
ob	ob
propter	propter
sine	sine	sino	sinum
@Section 13
Africa	Africa	Africanus
animus	animus
Asia	Asia#1	Asius	asia
auxilium	auxilia	auxilium
captivus	captivus
castra	castra	castro	castrum
copia	copia#1	copis#1
dominus	dominus
fama	fama
fuga	fuga	fugo
liber	liber#2	
magister	magister
numerus	numerus
signum	signum
@Section 14
ambulo	ambulo
clamo	clamo
confirmo	confirmo
demonstro	demonstro
libero	libero
arma	arma
consilium	consilium
impedimentum	impedimentum
proelium	proelium
telum	telum
nunc	nunc
@Section 15
@Section 16
oppugno	oppugno#1
servo	servo	
sto	sto
tempto	tento
do	do#1
bene	bene	
cras	cras	
diu	diu
heri	heri
hodie	hodie
iam	jam
ibi	ibi
male	malus#1	
postea	postea
@Section 17
@Section 18
causa	causa
epistula	epistula
fabula	fabula#1
hora	hora#1
pecunia	pecunia
regina	regina
Iulia	Julius
Lucius	Lucius#1
Marcus	Marcus#2
amicus	amicus#1
gratus	gratus
inimicus	inimicus
novus	novus
paratus	paro#1	
verus	verus
@Section 19
audacia	audacia
cura	cura	
inopia	inopia
ira	ira
poena	poena
carrus	carrus
locus	locus
populus	populus#1
socius	socius
interim	interim
saepe	saepe	
semper	semper
tum	tum
ubi	ubi
@Section 20
@Section 21
Caesar	Caesar
consul	consul
dux	dux
frater	frater
imperator	imperator
mater	mater
miles	miles
pater	pater
rex	rex
soror	soror
@Section 22
caput	caput
celeritas	celeritas
corpus	corpus
diligentia	diligentia
flumen	flumen
iter	iter	
nomen	nomen
tempus	tempus
vulnus	vulnus
Germanus	Germanus
Graecus	Graecus
Hispanus	Hispanus
Romanus	Romanus
@Section 23
habeo	habeo
maneo	maneo
moneo	moneo
moveo	moveo
sedeo	sedeo
teneo	teneo
timeo	timeo
video	video
@Section 24
acer	acer#2
audax	audax
brevis	brevis
celer	celer#1	
facilis	facilis
fortis	fortis
gravis	gravis
omnis	omnis
potens	possum
similis	similis
Britannus	Britannus
Gallus	Gallus#2
Helvetius	Helvetius
Troianus	Trojanus
@Section 25
@Section 26
@Section 27
aestas	aestas
hiems	hiems
lux	lux
pax	pax
salus	salus
vox	vox
debeo	debeo
doceo	doceo
iubeo	jubeo
prohibeo	prohibeo
respondeo	respondeo
retineo	retineo
terreo	terreo	
@Section 28
unus	unus
duo	duo
tres	tres
quattuor	quattuor
quinque	quin
sex	sex
septem	septem
octo	octo
novem	novo
decem	decem
undecim	undecim
duodecim	
viginti	viginti
centum	centum
mille	mille
primus	primus
secundus	secundus#1
tertius	tertius
quartus	quartus
quintus	quintus#1
sextus	sextus#1
septimus	septimus
octavus	octavus
nonus	nonus
decimus	decimus#1
iniuria	injuria	
pugna	pugna
victoria	victoria
Britannia	Britannia
Graecia	
Helvetia	Helvetius
Sicilia	Sicilia
Troia	Troja
atque	atque
aut	aut
olim	olim
quod	qui#1
si	si
@Section 29
animal	animal
civis	civis
finis	finis
gens	gens
hostis	hostis	
ignis	ignis
mare	mare
mons	mons
mors	mors
navis	navis
pons	
urbs	urbs
@Section 30
@Section 31
dico	dico#2
duco	duco
gero	gero#1
mitto	mitto
peto	peto
pono	pono
scribo	scribo
vinco	vinco
@Section 32
ago	ago
cogo	cogo
curro	curro
defendo	defendo
rego	rego
relinquo	relinquo
surgo	surgo
trado	trado
@Section 33
auctoritas	auctoritas
clamor	clamor
eques	eques
libertas	libertas
pedes	pes
hic	hic
ille	ille
is	is
@Section 34
iudex	judex
lapis	lapis
legio	legio
nox	nox
princeps	princeps
ego	ego
nos	nos
tu	tu
vos	tu
@Section 35
@Section 36
antiquus	antiquus
clarus	clarus
finitimus	finitimus
pauci	paucus
reliquus	reliquus
constituo	constituo
contendo	contendo
deligo	deligo#1
discedo	discedo
excedo	excedo
reduco	reduco
@Section 37
civitas	civitas
homo	homo
labor	labor#2
lex	lex
multitudo	multitudo
pars	pars
pes	pes
timor	timor
virtus	virtus
@Section 38
cibus	cibus
modus	modus
murus	murus
nihil	nihil
amitto	amitto
committo	committo
expello	expello
reddo	reddo
@Section 39
adventus	adventus
cornu	cornu
domus	domus
exercitus	exercitus#3
fluctus	fluctus
impetus	impetus
manus	manus#1
occasus	occasus#2
passus	passus#4
@Section 40
@Section 41
audio	audio
impedio	impedio
munio	munio
venio	venio
convenio	convenio
invenio	invenio
pervenio	pervenio
@Section 42
capio	capio#1	
cupio	cupio
facio	facio
fugio	fugio
iacio	jacio
accipio	accipio
conficio	conficio
conicio	conicio
incipio	incipio
interficio	interficio
@Section 43
acies	acies
dies	dies
meridies	meridies
res	res
!res publica	reor	res
spes	spes
etiam	etiam
itaque	ita
nam	nam
neque	neque
tamen	tamen
@Section 44
gaudium	gaudium
officium	officium
praemium	praemium
praesidium	praesidium
tergum	tergum
absum	absum
adsum	adsum
possum	possum
contineo	contineo
sustineo	sustineo
inquit	inquam
@Section 45
@Section 46
aequus	aequus
amplus	amplus
barbarus	barbarus
certus	certus
dexter	dexter
diligens	diligens
felix	felix#1	
iniquus	iniquus
iustus	justus
notus	nosco
posterus	posterus
proximus	proximus
sinister	sinister
summus	superus
utilis	utilis
quam	quam
@Section 47
capidus	
difficilis	difficilis
dissimilis	dissimilis
durus	durus
extremus	extremus
idoneus	idoneus
inferior	inferus
infimus	in-fio
medius	medius
nobilis	nobilis
par	par
propinquus	propinquus
publicus	publicus
validus	validus
nisi	nisi
postquam	postquam
@Section 48
cotidie	cottidie
deinde	deinde
eo	eo#2	
facile	facilis
huc	huc
magis	magis#3
magnopere	magnopere
multo	multus
multum	multus
nondum	nondum
numquam	numquam
paene	paene
paulo	paulus#1
paulum	paulus#1
primo	primus
primum	primus
prope	prope
statim	statim
tandem	tandem
undique	undique
@Section 49
alius	alius#2
alter	alter
neuter	neuter
nullus	nullus
solus	solus#1
totus	totus#1	
ullus	ullus
uter	uter#3
uterque	uter#3
subsidium	subsidium
toga	toga
victor	victor#1
idem	idem
ipse	ipse
simul	simul
@Section 50
@Section 51
cognosco	cognosco
credo	credo
existimo	existimo
frango	frango
intellego	intellego
iungo	jungo
obtineo	obtineo
puto	puto	
remitto	remitto
removeo	removeo
scio	scio	
sentio	sentio
spero	spero
traho	traho
valeo	valeo
Vale	valeo
@Section 52
accedo	accedo
cedo	cedo#1
claudo	claudo#1
desisto	desisto
dubito	dubito
instruo	instruo
iudico	judico
lego	lego#2
ludo	ludo	
pertineo	pertineo
premo	premo
probo	probo
recipio	recipio
@Section 53
arbor	arbor#1
collis	collis	
cupiditas	cupiditas
gloria	gloria	
liberi	liberi
luna	luna#1	
mora	mora#1
negotium	negotium
senator	senator
sol	sol
stella	stella	
turris	turris
ventus	ventus
apud	apud
circum	circum	
praeter	praeter
pro	pro#1
@Section 54
adduco	adduco
circumvenio	circumvenio
commoveo	commoveo
compleo	compleo
conspicio	conspicio#1
deficio	deficio
dimitto	dimitto
enuntio	enuntio
expono	expono
incito	incito
occido	occido#1
intermitto	intermitto
opprimo	opprimo
traduco	traduco
interior	interior
prior	prior
superior	superus
@Section 55
@Section 56
pilum	pilum	
scutum	scutum
tribunus	tribunus
valles	valles	
armo	armo	
cosisto	co-sisto
erro	erro#1	erro#2
perficio	perficio
perterreo	perterreo
quaero	quaero
rogo	rogo	
autem	autem
enim	enim
vel	vel
vero	verus
@Section 57
calamitas	calamitas
centurio	centurio#2
condicio	condicio
consuetudo	consuetudo
difficultas	difficultas
fossa	fossa	
hiberna	hibernus
insidiae	insidiae
iudicium	judicium
orbis	orbis	
potestas	potestas
regio	regio
sententia	sententia
vadum	vadum
subito	subeo
umquam	umquam
@Section 58
altitudo	altitudo
dolor	dolor
genus	genus#2
ius	jus
latitudo	latitudo
magnitudo	magnitudo
mens	mens
mercator	mercator
onus	onus
opus	opus#1
oratio	oratio
impero	impero
mando	mando#1	
oro	oro
persuadeo	persuadeo
postulo	postulo
@Section 59
ita	ita
necesse	necesse
satis	satis
sic	sic
talis	talis	
tam	tam
tantus	tantus
tot	tot
tredecim	
quattuordecim	
quindecim	
sedecim	
septendecim	
duodeviginti	
undeviginti	
ergo	ergo
praeterea	praeterea
procul	procul
@Section 60
@Section 61
aedificium	aedificium
cursus	cursus
exitus	exitus#2
fides	fides#1	
forum	forum#1	
nemo	nemo
oculus	oculus
portus	portus
senatus	senatus
species	species	
vestis	vestis
vigilia	vigilia
vis	vis
communis	communis
immortalis	immortalis
privatus	privo
quantus	quantus
@Section 62
colloquium	colloquium
imperium	imperium
initium	initium
sagitta	sagitta
spatium	spatium
studium	studium
tempestas	tempestas
defessus	de_-fateor
impeditus	impedio
mirus	mirus
conservo	conservo
incendo	incendo
pello	pello
permitto	permitto
permoveo	permoveo
produco	produco
propono	propono
renuntio	renuntio
vasto	vasto	
@Section 63
arbitror	arbitror
conor	conor
hortor	hortor
loquor	loquor
moror	moror#1
patior	patior
polliceor	polliceor
proficiscor	proficiscor
sequor	sequor
consequor	consequor
vereor	vereor
videor	video
aggredior	aggredior
congredior	congredior
egredior	egredior
progredior	progredior
@Section 64
eo	eo#1	
adeo	adeo#1	
exeo	exeo
redeo	redeo
transeo	transeo
fero	fero
adfero	affero
confero	confero
!se conferre	sui
infero	infero	
!bellum inferre	bellum	bellus
!signum inferre	signum
refero	refero
quidam	quidam
tutus	tueor
ulterior	
ultimus	ulter
Rhenus	Rhenus
rursus	rursus
@Section 65
@Section 66
volo	volo#1	
nolo	nolo
malo	malo
aetas	aetas
classis	classis
facultas	facultas
mensis	mensis	
ordo	ordo
interea	interea
quidem	quidem
quo	quo
quoque	quo
appropinquo	appropinquo
comparo	comparo#1	
comparo comparo#2
conscribo	conscribo
exerceo	exerceo
instituo	instituo
ostendo	ostendo
veho	veho
@Section 67
caedes	caedes	
munitio	munitio
obses	
ratio	ratio
ripa	ripa
aeger	aeger
apertus	aperio	
egregius	egregius
integer	integer
levis	levis#1	
maritimus	maritimus
militaris	militaris
necessarius	necessarius
prudens	prudens
recens	recens
vetus	vetus
fio	fio
@Section 68
audeo	audeo
cado	cado
caedo	caedo
hiemo	hiemo
orior	orior
potior	potior	
tango	tango
tollo	tollo
utor	utor
bis	bis
circiter	circiter
fere	fere
frustra	frustra	
item	item	
omnino	omnino
repente	repens#2
supra	supra
vix	vix
@Section 69
agmen	agmen
ancora	ancora
auctor	auctor
casus	casus#1
latus	latus#2
palus	palus#1
praeda	praeda
accido	accido#2
augeo	augeo
doleo	doleo
exploro	exploro
iuvo	juvo
licet	licet
oportet	oportet
perturbo	perturbo
ceteri	ceterus
complures	complures
@Section 70
@Section 71
confido	confido
consulo	consulo
desum	desum
noceo	noceo
parco	parco
pareo	pareo
placeo	placeo
praeficio	praeficio
praesum	praesum
provideo	provideo
resisto	resisto
studeo	studeo
turpis	turpis
vehemens	vehemens
@Section 72
beneficium	beneficium
causa	causa
cohors	cohors
custos	custos
equitatus	equitatus#1	
explorator	explorator
lacrima	lacrima	
laus	laus
litus	litus#3
magistratus	magistratus	
mulier	mulier
opinio	opinio
plebs	plebs
remus	remus#3
saxum	saxum
usus	usus#2	
uxor	uxor
vallum	vallum	
@Section 73
adulescens	adulescens
gratia	gratia
mos	mos
quies	quies#1
rumor	rumor
sanguis	sanguis
voluntas	voluntas
aperio	aperio
coepi	coepio
consuesco	consuesco
incolo	incolo#1
mereor	mereor
miror	miror
morior	morior
nascor	nascor
rapio	rapio
rumpo	rumpo	
sumo	sumo
vivo	vivo
@Section 74
ascendo	ascendo
conscendo	conscendo
deduco	deduco
defero	defero
descendo	descendo
efficio	efficio
ineo	ineo
reficio	reficio
repello	repello
revertor	revorto
tribuo	tribuo
verto	verto
aliquis	aliquis
inde	inde	
quisquam	quisquam
quisque	quisque
quot	quot
unde	unde
@Section 75
