#First Year Latin 1990 Jenney, Charles
@Lesson 1
agricola	agricola#1
femina	femina	
patria	patrius#1	
provincia	provincia
puella	puella
silva	silva
terra	terra
via	via	
villa	villa	
est	sum#1
sunt	sum#1
in	in
@Lesson 2
fabula	fabula#1
familia	familia
filia	filia
poeta	poeta	
regina	regina
vita	vita	
amo	amo
habito	habito
laudo	laudo
narro	narro
voco	voco
cum	cum
et	et
@Lesson 3
ab	ab
ad	ad
de	de#2
ex	ex
in	in
sub	sub
dea	dea
nauta	nauta
ambulo	ambulo
navigo	navigo
occupo	occupo
specto	specto
sum	sum#1
ubi	ubi
unde	unde
super	super#2	
non	non
quo	quo
@Lesson 4
ager	ager
amicus	amicus#2
auxilium	auxilium
bellum	bellum	
legatus	legatus	
nuntius	nuntius
oppidum	oppidum
puer	puer
verbum	verbum
vir	vir
paro	paro#1	
porto	porto
contra	contra
itaque	ita	
@Lesson 5
fuga	fuga	
periculum	periculum
amicus	amicus#1
ferus	ferus
inimicus	inimicus
magnus	magnus#1
malus	malus#1	
miser	miser
multus	multus
pauci	paucus
pulcher	pulcher#1
aedificio	aedificium
sed	sed
@Lesson 6
deus	deus
filius	filius
liberi	liberi	
servus	servus#2
altus	altus#1	
bonus	bonus
liber	liber#2	
longus	longus
meus	meus
noster	noster
tuus	tuus
vester	vester
bene	bene	
male	malus#1	
@Lesson 7
annus	annus
donum	donum
equus	equus#1
porta	porta	
somnus	somnus
latus	latus#1	
supero	supero	
volo	volo#2	
olim	olim
post	post
saepe	saepe	
per	per
post	post
@Lesson 8
caelum	caelum#2	
campus	campus#3
fortuna	fortuna	
regnum	regnum
convoco	convoco
exspecto	exspecto
ante	ante
cur	cur
iam	jam
interim	interim
nunc	nunc
tum	tum
ante	ante
trans	trans
@Lesson 9
insula	insula#1
lingua	lingua
umbra	umbra	
parvus	parvus
do	do#1	
sto	sto
cras	cras	
heri	heri
hodie	hodie
ibi	ibi
modo	modo	
@Lesson 10
amicitia	amicitia
ara	ara	
dominus	dominus
frumentum	frumentum
inopia	inopia
locus	locus
magister	magister
populus	populus#1	
socius	socius
sacer	sacer
nuntio	nuntio	
pugno	pugno	
diu	diu
@Lesson 11
copia	copia#1	
fama	fama
ira	ira
telum	telum
laetus	laetus#1
novus	novus
paratus	paro#1	
clamo	clamo
demonstro	demonstro
laboro	laboro
libero	libero
servo	servo	
rursus	rursus
semper	semper
@Lesson 12
anima	anima	
animus	animus
aqua	aqua
consilium	consilium
captivus	captivus
foedus	foedus#1
gratus	gratus
verus	verus
confirmo	confirmo
iuvo	juvo
circum	circum	
inter	inter
prope	prope
mox	mox
@Lesson 13
amor	amor
flamma	flamma#1	
frater	frater
mater	mater
nepos	nepos#1
pater	pater
soror	soror
carus	carus#1
finitimus	finitimus
idoneus	idoneus
notus	nosco	
propinquus	propinquus
vicinus	vicinus
@Lesson 14
auctor	auctor
cupido	cupido	
cura	cura	
decus	decus#1
gratia	gratia
imperium	imperium
laus	laus
memoria	memoria
munus	munus
numen	numen
pectus	pectus
timor	timor
virtus	virtus
@Lesson 15
iter	iter	
multitudo	multitudo
nomen	nomen
acer	acer#1	
celer	celer#1	
dignus	dignus
ingens	ingens
memor	memor#1
omnis	omnis
par	par
similis	similis
vetus	vetus
@Lesson 16
amnis	amnis
arx	arx
caedes	caedes	
hostis	hostis	
ignis	ignis
imber	imber
mare	mare	
mors	mors
navis	navis	
parens	parens#2
pars	pars
urbs	urbs
vis	vis	
@Lesson 17
careo	careo	
habeo	habeo
iaceo	jaceo
maneo	maneo
teneo	teneo
timeo	timeo
video	video
prae	prae
pro	pro#1	
@Lesson 18
dolor	dolor
dux	dux
gaudium	gaudium
homo	homo
rex	rex
cedo	cedo#1
duco	duco
mitto	mitto
peto	peto
pono	pono
rego	rego
@Lesson 19
anguis	anguis
carmen	carmen#1	
herba	herba
lex	lex
uxor	uxor
aspicio	aspicio
respicio	respicio
capio	capio#1	
facio	facio
denique	denique
paene	paene
statim	statim
@Lesson 20
aurum	aurum
gens	gens
pius	pius
tristis	tristis
aperio	aperio
audio	audio
erro	erro#1	
misceo	misceo
moveo	moveo
muto	muto#2	
reperio	reperio
venio	venio
@Lesson 21
unus	unus
duo	duo
tres	tres
quattuor	quattuor
quinque	quin
sex	sex
septem	septem
octo	octo
novem	novo
decem	decem
undecem	
duodecim	
tredecim	
quattuordecim	
quindecim	
sedecim	
septendecim	
duodeviginti	
undeviginti	
viginti	viginti
primus	primus
secundus	secundus#1
tertius	tertius
quartus	quartus
quintus	quintus#1
sextus	sextus#1
septimus	septimus
octavus	octavus
nonus	nonus
decimus	decimus#1
undecimus	undecimus
duodecimus	duodecimus
tertius	tertius
quartus	quartus
quintus	quintus#1
sextus	sextus#1
septimus	septimus
duodevicesimus	duodevicesimus
undevicesimus	undevicesimus
vicesimus	vicesimus
altitudo	altitudo
forma	forma	
latitudo	latitudo
longitudo	longitudo
mons	mons
nemo	nemo
fortis	fortis
@Lesson 22
triginta	triginta
quadraginta	
quinquaginta	quinquaginta
sexaginta	sexa_ginta
septuaginta	septuaginta
octoginta	octoginta
nonaginta	nonaginta
centum	centum
tricesimus	
quadragesimus	quadragesimus
quinquagesimus	quinquagesimus
sexagesimus	sexagesimus
septuagesimus	septuagesimus
octogesimus	octogesimus
nonagesimus	nonagesimus
centesimus	centesimus
ducenti	ducenti	
trecenti	trecenti
quadringenti	quadringenti
quingenti	quingenti
sescenti	sescenti
septingenti	septingenti
octingenti	octingenti
nongenti	nongenti
mille	mille
ducentesimus	
trecentesimus	trecentesimus
quadringentesimus	quadringentesimus
quingentesimus	quingentesimus
sescentesimus	sescentesimus
septingentesimus	septingentesimus
octingentesimus	
nongentesimus	
millesimus	millesimus
avis	avis	
fatum	fatum	
pecunia	pecunia
pes	pes
saeculum	saeculum
aureus	aureus
secundus	secundus#1
emo	emo
vendo	vendo
@Lesson 23
arma	arma	
castra	castra	
tempus	tempus
clarus	clarus
iuvenis	juvenis
mirus	mirus
talis	talis
tantus	tantus
tot	tot
ergo	ergo
iterum	iterum
totiens	totiens
@Lesson 24
corpus	corpus
os	os#1	
virgo	virgo
gravis	gravis
vivus	vivus
iacio	jacio
vincio	vincio
vinco	vinco
vivo	vivo	
etiam	etiam
quoque	quo
tamen	tamen
@Lesson 25
civis	civis
fors	fors
hora	hora#1
litus	litus#3
natura	natura
nox	nox
sanguis	sanguis
ceteri	ceterus
felix	felix#1	
fugio	fugio
inquam	inquam
quidem	quidem
@Lesson 26
aedes	aedes
aetas	aetas
caput	caput
imago	imago
mens	mens
modus	modus
absum	absum
ardeo	ardeo
colo	colo#1	
lego	lego#2
relinquo	relinquo
trado	trado
@Lesson 27
coniunx	conjunx
flumen	flumen
oculus	oculus
sol	sol
studium	studium
aeternus	aeternus
plenus	plenus
verso	verso	
verto	verto
deinde	deinde
igitur	igitur
apud	apud
@Lesson 28
hospes	hospes
moenia	moenia#1	
sedes	sedes	
signum	signum
vestis	vestis
posterus	posterus
posterum	posterus
claudo	claudo#1	
curro	curro
expono	expono
sedeo	sedeo
circa	circo
quando	quando
@Lesson 29
cor	cor	
cornu	cornu	
cursus	cursus
domus	domus
impedimentum	impedimentum
manus	manus#1
milia	mille
passus	passus#4
salus	salus
usus	usus#2	
doceo	doceo
rogo	rogo	
@Lesson 30
dies	dies
facies	facies	
fides	fides#1	
humus	humus
res	res
rus	rus
species	species	
spes	spes
publicus	publicus
rusticus	rusticus
@Lesson 31
metus	metus
versus	versus#2	
adsum	adsum
fero	fero	
impono	impono
insto	insto
ostendo	ostendo
praesto	praesto#2	
promitto	promitto
prosum	prorsum	
@Lesson 32
abeo	abeo
adeo	adeo#1	
obeo	obeo
pereo	pereo
praetereo	praetereo
redeo	redeo
subeo	subeo
transeo	transeo
@Lesson 33
fruor	fruor
fungor	fungor
gaudeo	gaudeo
memini	memini	
moror	moror#1	
obliviscor	obliviscor
patior	patior
potior	potior	
utor	utor
vereor	vereor
vescor	vesco
@Lesson 34
coepi	coepio
constituo	constituo
cupio	cupio
debeo	debeo
desino	desino
opto	opto
propero	propero	
tempto	tento
numquam	numquam
umquam	umquam
@Lesson 35
audeo	audeo
cesso	cesso
cogo	cogo
doleo	doleo
dubito	dubito
iubeo	jubeo
iuro	juro
soleo	soleo
spero	spero
valeo	valeo
@Lesson 36
cerno	cerno
dico	dico#2
existimo	existimo
moneo	moneo
nego	nego
nosco	nosco
puto	puto	
scio	scio	
scribo	scribo
sentio	sentio
@Lesson 37
exercitus	exercitus#3
genus	genu	
miles	miles	
plebs	plebs
proelium	proelium
dissimilis	dissimilis
gracilis	gracilis	
humilis	humilis
nobilis	nobilis
adversus	adversus#3
@Lesson 38
acies	acies
numerus	numerus
vox	vox
caecus	caecus#1
dexter	dexter
inferus	inferus
senex	senex
sinister	sinister
superus	superus
nascor	nascor
@Lesson 39
ars	ars
casus	casus#2
gloria	gloria	
labor	labor#2
princeps	princeps
ventus	ventus
aequus	aequus
varius	varius#2
simul	simul
vix	vix
@Lesson 40
causa	causa
honor	honor
ius	jus
maritus	maritus#1
opus	opus#1
turba	turbo#1
haud	haud
procul	procul
ob	ob
propter	propter
