#First Year Latin 1979 Jenney, Charles
@Section 1
agricola	agricola#1
aqua	aqua
femina	femina	
fortuna	fortuna	
Gallia	Gallia	
insula	insula#1
Italia	Italia
lingua	lingua
litterae	littera
memoria	memoria
natura	natura
poeta	poeta	
provincia	provincia
puella	puella
silva	silva
vita	vita	
est	sum#1
sunt	sum#1
@Section 2
amicitia	amicitia
patria	patrius#1
amo	amo
do	do#1
laudo	laudo
navigo	navigo
occupo	occupo
paro	paro#1	
pugno	pugno	
specto	specto
voco	voco
non	non
et	et
sed	sed
@Section 3
Europa	Europa	
Germania	Germania
Hispania	Hispania
nauta	nauta
porta	porta	
Roma	Roma
terra	terra
tuba	tuba
via	via	
villa	
quid	quis#1	
ubi? (int adv)	
-ne	
-que	
@Section 4
ager	ager
amicus	amicus#2
annus	annus
campus	campus#2
dea	dea
deus	deus
equus	equus#1
filia	filia
filius	filius
gladius	gladius
legatus	lego#1
ludus	ludus
nuntius	nuntius
puer	puer
servus	servus#2
vir	vir
@Section 5
bellum	bellum	
caelum	caelum#2
donum	donum
frumentum	frumentum
oppidum	oppidum
periculum	periculum
regnum	regnum
verbum	verbum
ab	ab
ad	ad
de	de#2
ex	ex
in	in
sub	sub
@Section 6
altus	altus#1	
bonus	bonus
ferus	ferus
latus	latus#1	
longus	longus
magnus	magnus#1
malus	malus#1	
meus	meus
multus	multus
parvus	parvus
tuus	tuus
cum (prep)	cum
sine	sine	
@Section 7
appello	appello#1
convoco	convoco
exspecto	exspecto
habito	habito
laboro	laboro
narro	narro
nuntio	nuntio	
supero	supero	
volo	volo#2	
vulnero	vulnero
@Section 8
liber	liber#2	
miser	miser
noster	noster
pulcher	pulcher#1
sacer	sacer
vester	vester
ante	ante
contra	contra
inter	inter
ob	ob
per	per
post	post
propter	propter
trans	trans
@Section 9
bene	bene	
cras	cras	
cur	cur
diu	diu
heri	heri
hodie	hodie
iam	jam
ibi	ibi
interim	interim
male	malus#1	
nunc	nunc
postea	postea
saepe	saepe	
semper	semper
tuum	tuus
ubi (rel)	ubi
@Section 10
ambulo	ambulo
clamo	clamo
confirmo	confirmo
demonstro	demonstro
libero	libero
oppugno	oppugno#1	
servo	servo	
sto	sto
tempto	tento
Africa	Africa	
Asia	Asia#1	
num	num	
@Section 11
animus	animus
arma	arma	
auxilium	auxilium
captivus	captivus
castra	castra	
consilium	consilium
copia	copia#1	
fama	fama
fuga	fuga
impedimentum (n)	impedimentum
impedimenta (n, pl)	impedimentum
numerus	numerus
proelium	proelium
signum	signum
telum	telum
@Section 12
audacia	audacia
carus	carus#1
cura	cura
dominus	dominus
inopia	inopia
ira	ira
liber	liber#4	
locus	locus
magister	magister
poena	poena
populus	populus#1
socius	socius
@Section 13
causa	causa
epistula	epistula
fabula	fabula#1
hora	hora#1	
Iulia	Julius
albus	albus
amicus	amicus#1
gratus	gratus
inimicus	inimicus
niger	niger
novus	novus
paratus	paro#1
verus	verus
Iulius	Julius
Lucius	Lucius#1
Marcus	Marcus#2
pecunia	pecunia
regina	regina
@Section 14
celeritas	celeritas
consul	consul
dux	dux
frater	frater
imperator	imperator
imperium	imperium
mater	mater
miles	miles
pater	pater
rex	rex
soror	soror
delecto	delecto	
mox	mox
@Section 15
Caesar	Caesar
caput	caput
carmen	carmen#1
corpus	corpus
diligentia	diligentia
flumen	flumen
iter	iter	
nomen	nomen
tempus	tempus
vulnus	vulnus
Germanus	Germanus
Graecus	Graecus
Hispanus	Hispanus
Romanus	Romanus
@Section 16
animal	animal
civis	civis
finis	finis
gens	gens
hostis	hostis	
ignis	ignis
mare	mare	
mons	mons
mors	mors
navis	navis	
panis	panis	
pons	
urbs	urbs
@Section 17
Helvetius	Helvetius
habeo	habeo
maneo	maneo
moneo	moneo
moveo	moveo
sedeo	sedeo
teneo	teneo
timeo	timeo
video	video
@Section 18
acer	acer#2
audax	audax
brevis	brevis
Britanus	
celer	celer#1	
facilis	facilis
fortis	fortis
Gallus	Gallus#2
gravis	gravis
omnis	omnis
potens	possum
similis	similis
Troianus	Trojanus
@Section 19
@Section 20
aestas	aestas
hiems	hiems
lux	lux
debeo	debeo
doceo	doceo
prohibeo	prohibeo
respondeo	respondeo
retineo	retineo
terreo	terreo	
pax	pax
salus	salus
vox	vox
@Section 21
unus	unus
duo	duo
tres	tres
quattuor	quattuor
quinque	quin
sex	sex
septem	septem
octo	octo
novem	novo
decem	decem
undecim	undecim
duodecim	
viginti	viginti
centum	centum
mille	mille
primus	primus
secundus	secundus#1
tertius	tertius
quartus	quartus
quintus	quintus#1
sextus	sextus#1
septimus	septimus
octavus	octavus
nonus	nonus
decimus	decimus#1
Britannia	Britannia
cena	cena	
fenestra	fenestra
Graecia	
Helvetia	Helvetius
iniuria	injuria	
mensa	mensa	
pugna	pugna	
sella	sella
Sicilia	Sicilia
Troia	Troja
victoria	victoria
atque	atque
aut	aut
quod	qui#1
si	si
@Section 22
ago	ago
cogo	cogo
defendo	defendo
duco	duco
gero	gero#1	
mitto	mitto
pono	pono
rego	rego
relinquo	relinquo
surgo	surgo
trado	trado
vinco	vinco
@Section 23
antiquus	antiquus
clarus	clarus
finitimus	finitimus
pauci	paucus
reliquus	reliquus
cedo	cedo#1
constituo	constituo
contendo	contendo
deligo	deligo#1
discedo	discedo
excedo	excedo
reduco	reduco
@Section 24
accipio	accipio
capio	capio#1	
conficio	conficio
conicio	conicio
cupio	cupio
facio	facio
fugio	fugio
iacio	jacio
incipio	incipio
interficio	interfacio
@Section 25
eques	eques
pedes	pes
is	is
hic	hic
ille	ille
bibo	bibo#1	
curro	curro
dico	dico#2
edo	edo#1	
peto	peto
scribo	scribo
olim	olim
@Section 26
auctoritas	auctoritas
avis	avis	
canis	canis#1	
clamor	clamor
iudex	judex
lapis	lapis
legio	legio
libertas	libertas
nox	nox
princeps	princeps
timor	timor
@Section 27
civitas	civitas
homo	homo
hortus	hortus
labor	labor#2
lex	lex
multitudo	multitudo
pars	pars
pes	pes
virtus	virtus
@Section 28
cibus	cibus
modus	modus
murus	murus
nihil	nihil
vinum	vinum	
amitto	amitto
committo	committo
expello	expello
reddo	reddo
@Section 29
adventus	adventus
cornu	cornu	
cursus	cursus
domus	domus
exercitus	exercitus#3
exitus	exitus#2
fluctus	fluctus
impetus	impetus
manus	manus#1
occasus	occasus#2
passus	passus#4
portus	portus
senatus	senatus
usus	usus#2
@Section 30
milia	mille
audio	audio
convenio	convenio
dormio	dormio
impedio	impedio
invenio	invenio
munio	munio
pervenio	pervenio
venio	venio
etiam	etiam
tamen	tamen
nam	nam
@Section 31
acies	acies
dies	dies
ianua	janua
lectus	lectus#2
meridies	meridies
res	res
spes	spes
frumentarius	frumentarius
publicus	publicus
itaque	ita	
neque	neque
@Section 32
gaudium	gaudium
officium	officium
praemium	praemium
praesidium	praesidium
tergum	tergum
absum	absum
adsum	adsum
contineo	contineo
inquam	inquam
iubeo	jubeo
possum	possum
sustineo	sustineo
@Section 33
aequus	aequus
amplus	amplus
barbarus	barbarus
certus	certus
diligens	diligens
felix	felix#1	
iniquus	iniquus
iustus	justus
laetus	laetus#1
notus	nosco
tristis	tristis
utilis	utilis
quam	quam
@Section 34
aureus	aureus
cupidus	cupidus
dexter	dexter
difficilis	difficilis
dissimilis	dissimilis
durus	durus
fidelis	fidelis
idoneus	idoneus
nobilis	nobilis
par	par
posterus	posterus
propinquus	propinquus
propior	propio
proximus	proximus
sinister	sinister
validus	validus
magis	magis#3	
magnopere	magnopere
maxime	magnus#1
nisi	nisi	
@Section 35
plus	multus
medius	medius
senex	senex
natu	natus#2
prope	prope
@Section 36
paulum	paulus#1
cotidie	cottidie
deinde	deinde
eo	eo#2	
huc	huc
illuc	illic
nondum	nondum
numquam	numquam
paene	paene
quo	quo
simul	simul
statim	statim
tandem	tandem
atque	atque
postquam	postquam
ut	ut
@Section 37
herba	herba
subsidium	subsidium
toga	toga
victor	victor#1
alienus	alienus
quisque	quisque
unde	unde
undique	undique
@Section 38
claudo	claudo#2
cresco	cresco
desisto	desisto
dubito	dubito
frango	frango
instruo	instruo
iungo	jungo
lavo	lavo
ludo	ludo
premo	premo
probo	probo	
recipio	recipio
remitto	remitto
removeo	removeo
traho	traho
valeo	valeo
@Section 39
accedo	accedo
cognosco	cognosco
credo	credo
existimo	existimo
intellego	intellego
iudico	judico
lego	lego#2
nego	nego
nescio	nescio	
obtineo	obtineo
pertineo	pertineo
puto	puto	
scio	scio	
sentio	sentio
spero	spero
apud	apud
circum	circum	
praeter	praeter
pro	pro#1
@Section 40
arbor	arbor#1
collis	collis	
cupiditas	cupiditas
gloria	gloria	
liberi	liberi	
luna	luna#1	
mora	mora#1	
negotium	negotium
senator	senator
sol	sol
stella	stella	
turris	turris
ventus	ventus
suus	suus
sui	sui
@Section 41
adduco	adduco
circumvenio	circumvenio
commoveo	commoveo
compleo	compleo
conspicio	conspicio#1
deficio	deficio
dimitto	dimitto
enuntio	enuntio
expono	expono
incito	incito
intermitto	intermitto
occido	occido#1
opprimo	opprimo
traduco	traduco
@Section 42
aurum	aurum
ferrum	ferrum
pilum	pilum	
armo	armo	
consisto	consisto
erro	erro#1	
perficio	perficio
perterreo	perterreo
ne	ne#1
vero	verus
autem	autem
enim	enim
vel	vel
scutum	scutum
tribunus	tribunus
valles	valles	
@Section 43
calamitas	calamitas
condicio	condicio
consuetudo	consuetudo
difficultas	difficultas
insidiae	insidiae
iudicium	judicium
orbis	orbis
potestas	potestas
regio	regio	
sententia	sententia
vadum	vadum
calidus	calidus
frigidus	frigidus
subito	subeo	
umquam	umquam
@Section 44
altitudo	altitudo
centurio	centurio#2
dolor	dolor
flos	
fossa	fossa
genus	genus#2
hiberna	hibernus
ius	jus
latitudo	latitudo
magnitudo	magnitudo
mens	mens
mercator	mercator
onus	onus
opus	opus#1
oratio	oratio
vallum	vallum	
@Section 45
impero	impero
mando	mando#1	
oro	oro
persuadeo	persuadeo
postulo	postulo
quaero	quaero
rogo	rogo	
ergo	ergo
praeterea	praeterea
procul	procul
an	an
@Section 46
aedificium	aedificium
auris	aura	auris	aurum
fides	fides#1	
forum	forum#1	
nemo	nemo
oculus	oculus
species	species	
vestis	vestis
vigilia	vigilia
vis	vis	
@Section 47
tredecim	
quattuordecim	
quindecim	
sedecim	
septendecim	
duodeviginti	
undeviginti	
communis	communis
immortalis	immortalis
privatus	privo
quantus	quantus
quot	quot
num	num	
utrum	uter	utrum
@Section 48
satis	satis
necesse	necesse
talis	talis
tantus	tantus
tot	tot
accido	accido#2
efficio	efficio
ita	ita	
tam	tam
sic	sic
@Section 49
sagitta	sagitta	
spatium	spatium
studium	studium
tempastas	
defessus	de_-fateor
impeditus	impedio
mirus	mirus
conservo	conservo	
incendo	incendo
pello	pello
permoveo	permoveo
produco	produco
propono	propono
renuntio	renuntio
vasto	vasto	
cum (conj)	cum
@Section 50
Athenae	Athenae
Carthago	Carthago#1
Corinthus	Corinthus
rus	rus
arbitror	arbitror
conor	conor
hortor	hortor
loquor	loquor
moror	moror#1	
patior	patior
permitto	permitto
polliceor	polliceor
profiscor	
videor	video
@Section 51
colloquium	colloquium
initium	initium
Rhenus	Rhenus
tutus	tueor
quidam	quidam
rursus	rursus
aggredior	aggredior
congredior	congredior
consequor	consequor
egredior	egredior
progredior	progredior
sequor	sequor
vereor	vereor
@Section 52
eo	eo#1	
adeo	adeo#1
exeo	exeo
redeo	redeo
transeo	transeo
ferro	ferrum
adfero	affero
confero	confero
infero	infero	
refero	refero
tollo	tollo
@Section 53
aetas	aetas
classis	classis
facultas	facultas
hospes	hospes
mensis	mensis	
ordo	ordo
appropinquo	appropinquo
comparo	comparo#2
conscribo	conscribo
disco	disco	
exerceo	exerceo
instituo	instituo
malo	malo
nolo	nolo
ostendo	ostendo
veho	veho
volo	volo#1	
interea	interea
quidem	quidem
quoque	quo
@Section 54
aedes	aedes
caedes	caedes	
munitio	munitio
obses	
ratio	ratio
ripa	ripa
aeger	aeger
apertus	aperio	
egregius	egregius
integer	integer
levis	levis#1	
maritimus	maritimus
militaris	militaris	
necessarius	necessarius
prudens	prudens
recens	recens
vetus	vetus
fio	fio
vendo	vendo
@Section 55
audeo	audeo
cado	cado	
caedo	caedo
emo	emo
hiemo	hiemo
orior	orior
potior	potior	
tango	tango
utor	utor
bis	bis
circiter	circiter
fere	fere
frustra	frustra	
item	item	
omnino	omnino
repente	repens#2
supra	supra
vix	vix
@Section 56
agmen	agmen
ancora	ancora
auctor	auctor
casus	casus#2
latus	latus#2	
os	os#1	os#2
palus	palus#1
praeda	praeda
ceteri	ceterus
complures	complures
augeo	augeo
consido	consido
convenit	convenio
doleo	doleo
exploro	exploro
licet	licet
oportet	oportet
perturbo	perturbo
suscipio	suscipio
tego	tego
vivo	vivo	
@Section 57
turpis	turpis
vehemens	vehemens
confido	confido
consulo	consulo
desum	desum
eripio	eripio
noceo	noceo
parco	parco
pareo	pareo
placeo	placeo
praeficio	praeficio
praesum	praesum
provideo	provideo
rapio	rapio
resisto	resisto
solvo	solvo
studeo	studeo
@Section 58
adulescens	adulescens
gratia	gratia
mos	mos
quies	quies#1
rumor	rumor
sanguis	sanguis
voluntas	voluntas
aliquis	aliquis
aliqui	aliqui	
quis	quis#1	
qui	qui#1	
quisquam	quisquam
quisque	quisque
aperio	aperio
coepi	coepio
consuesco	consuesco
iaceo	jaceo
incolo	incolo#1
iuvo	juvo
rideo	rideo
rumpo	rumpo	
sumo	sumo
@Section 59
beneficium	beneficium
cohors	cohors
custos	custos
equitatus	equitatus#1	
explorator	explorator
infans	infer
lacrima	lacrima	
laus	laus
litus	litus#3
magistratus	magistratus	
mulier	mulier
opinio	opinio
plebs	plebs
remus	remus#1	
saxum	saxum
uxor	uxor
inde	inde
@Section 60
ascendo	ascendo
coniungo	conjungo
conscendo	conscendo
deduco	deduco
defero	defero
descendo	descendo
ineo	ineo
mereor	mereor
miror	miror
morior	morior	
nascor	nascor
reficio	reficio
reicio	reicio
repello	repello
reperio	reperio
revertor	revorto
tribuo	tribuo
taceo	taceo
verto	verto
