#Second Year Latin 1979 Jenney, Charles
@
aestas	aestas
aeger	aeger
agricola	agricola#1
animal	animal
aqua	aqua
auxilium	auxilium
bellum	bellum
caput	caput
civis	civis
civitas	civitas
clamor	clamor
consul	consul
copia	copia#1	
cornu	cornu	
corpus	corpus
dea	dea
deus	deus
dies	dies
domus	domus
dux	dux
eques	eques
exercitus	exerceo	
exitus	exitus#2
femina	femina	
fenestra	fenestra	
filia	filia
filius	filius
finis	finis
flumen	flumen
fuga	fuga	
gladius	gladius
hiems	hiems
hostis	hostis	
imperator	imperator
infans	infer
insula	insula#1
locus	locus
magister	magister
manus	manus#1
mare	mare	
miles	miles	
mons	mons
navis	navis	
nox	nox
oculus	oculus
palus	palus#1
pars	pars
pater	pater
pax	pax
pedes	pes
pes	pes
pons	
porta	porta	
puella	puella
puer	puer
pugna	pugna	
regina	regina
regnum	regnum
res	res
rex	rex
scutum	scutum
sella	sella
servus	servus#2
spes	spes
telum	telum
turris	turris
urbs	urbs
via	via	
villa	villa	
vir	vir
vis	vis
vox	vox
vulnus	vulnus
@Section 2
acer	acer#2
adulescens	adulescens
alius	alius#2
alter	alter	
altus	altus#1	
audax	audax
bonus	bonus
brevis	brevis
celer	celer#1	
clarus	clarus
decimus	decimus#1
difficilis	difficilis
diligens	diligens
dissimilis	dissimilis
facilis	facilis
ferus	ferus
fidelis	fidelis
finitimus	finitimus
fortis	fortis
gratus	gratus
gravis	gravis
idoneus	idoneus
latus	latus#1	
levis	levis#1	
liber	liber#2	
longus	longus
malus	malus#1	
meus	meus
multus	multus
neuter	neuter
niger	niger
nobilis	nobilis
nonus	nonus
noster	noster
novus	novus
nullus	nullus
octavus	octavus
omnis	omnis
par	par
paratus	paro#1	
parvus	parvus
posterus	posterus
potens	possum	
primus	primus
pulcher	pulcher#1
quantus	quantus
quartus	quartus
quintus	quintus#1
secundus	secundus#1
septimus	septimus
sextus	sextus#1
similis	similis
solus	solus#1
summus	superus
suus	suus
tantus	tantus
tertius	tertius
totus	totus#1
tutus	tueor
tuus	tuus
ullus	ullus
unus	unus
utilis	utilis
vehemens	vehemens
vester	vester
vetus	vetus
@Section 3
ab	ab
ad	ad
ante	ante
apud	apud
at	at
atque	atque
aut	aut
autem	autem
centum	centum
circum	circum	
contra	contra
cum	cum
de	de#2
decem	decem
diu	diu
duo	duo
duodecim	
duodeviginti	
ex	ex
ego	ego
enim	enim
etiam	etiam
hic	hic
huc	huc
ille	ille
in	in
inter	inter
ipse	ipse
is	is
mille	mille
mox	mox
nam	nam
neque	neque
novem	novo
ob	ob
octo	octo
per	per
post	post
postquam	postquam
pro	pro#1	
propter	propter
quam	quam	
quattuor	quattuor
quattuordecim	
qui	qui#1	
quindecim	
quinque	quin
quis	quis#1	
quod	qui#1	
sed	sed
sedecim	
septem	septem
septendecim	
sex	sex
si	si
sine	sine	
sub	sub
tamen	tamen
tandem	tandem
trans	trans
tredecim	
tres	tres
tu	tu
undecim	undecim
undeviginti	
viginti	viginti
@Section 4
ago	ago
amo	amo
arbitror	arbitror
audio	audio
cado	cado	
caedo	caedo
capio	capio#1	
cedo	cedo#1
coepi	coepio
cognosco	cognosco
confero	confero
conor	conor
consequor	consequor
constituo	constituo
credo	credo
curro	curro
debeo	debeo
deficio	deficio
dico	dico#2
do	do#1	
doceo	doceo
duco	duco
eo	eo#1	
fero	fero	
gero	gero#1	
habeo	habeo
habito	habito
hortor	hortor
intellego	intellego
interficio	interficio
iubeo	jubeo
laboro	laboro
laudo	laudo
loquor	loquor
malo	malo
maneo	maneo
mitto	mitto
moneo	moneo
morior	morior	
moror	moror#1
moveo	moveo
munio	munio
molo	molo#1
paro	paro#1	
peto	peto
pono	pono
porto	porto
possum	possum
premo	premo
progredior	progredior
prohibeo	prohibeo
pugno	pugno	
quaero	quaero
refero	refero
rego	rego
retineo	retineo
rideo	rideo
scio	scio
scribo	scribo
sentio	sentio
sequor	sequor
solvo	solvo
sto	sto
sum	sum#1
tango	tango
teneo	teneo
terreo	terreo	
timeo	timeo
trado	trado
traho	traho
venio	venio
video	video
vinco	vinco
voco	voco
volo	volo#1	
@Section 5
acies	acies
adfero	affero
aedificium	aedificium
aperio	aperio
arma	arma	
audeo	audeo
avis	avis	
beneficium	beneficium
campus	campus#3
castra	castra	
celeritas	celeritas
cena	cena	
cogo	cogo
colloquium	colloquium
conficio	conficio
consuesco	consuesco
contendo	contendo
cupio	cupio
desisto	desisto
donum	donum
dubito	dubito
edo	edo#1	
epistula	epistula
existimo	existimo
exspecto	exspecto
fabula	fabula#1
facio	facio
frustra	frustra	
fugio	fugio
gens	gens
homo	homo
hora	hora#1
iacio	jacio
ianua	janua
iter	iter
iungo	jungo
legatus	lego#1
libero	libero
lbertas	
licet	licet
luna	luna#1	
lux	lux
mensa	mensa	
nuntio	nuntio	
nuntius	nuntius
obtineo	obtineo
occasus	occasus#2	
occupo	occupo
oportet	oportet
oppidum	oppidum
polliceor	polliceor
proficiscor	proficiscor
puto	puto	
rapio	rapio
sagitta	sagitta	
saxum	saxum
sedeo	sedeo
servo	servo	
species	species	
spero	spero
suscipio	suscipio
tempus	tempus
traduco	traduco
transeo	transeo
tuba	tuba
vasto	vasto
vendo	vendo
ventus	ventus
videor	video
vigilia	vigilia
vinum	vinum	
@Section 6
amicitia	amicitia
annus	annus
antiquus	antiquus
appello	appello#1
appropinquo	appropinquo
aegeo	a-egeo
calamitas	calamitas	
canis	canis#1	
classis	classis
collis	collis	
colloquor	colloquor
conscendo	conscendo
conscribo	conscribo
conservo	conservo	
cursus	cursus
custos	custos
defendo	defendo
deligo	deligo#1
egredior	egredior
eripio	eripio
exeo	exeo
explorator	explorator
facultas	facultas
fama	fama
ferrum	ferrum
fides	fides#1	
fluctus	fluctus
fortuna	fortuna
fossa	fossa	
frater	frater
frumentum	frumentum
genus	genu	
ignis	ignis
impetus	impetus
incendo	incendo
incolo	incolo#1
inopia	inopia
instruo	instruo
invenio	invenio
lavo	lavo
litus	litus#3
mensis	mensis	
nauta	nauta
navigo	navigo
nomen	nomen
oro	oro
os	os#1	
ostendo	ostendo
panis	panis	
passus	passus#4
periculum	periculum
perterreo	perterreo
portus	portus
princeps	princeps
redeo	redeo
relinquo	relinquo
respondeo	respondeo
senatus	senatus
signum	signum
sol	sol
specto	specto
studeo	studeo
subito	subeo	
supero	supero	
tempestas	tempestas
tempto	tento
terra	terra
timor	timor
vadum	vadum
veho	veho
verto	verto
vivo	vivo
volo	volo#2
vulnero	vulnero
@Section 7
adventus	adventus
aedes	aedes
agmen	agmen
aliquis	aliquis
ambulo	ambulo
amitto	amitto
ascendo	ascendo
auctor	auctor
bibo	bibo#1	
caedes	caedes	
caelum	caelum#2
casus	casus#2
causa	causa
ceteri	ceterus
cibus	cibus
committo	committo
confirmo	confirmo
consilium	consilium
convenio	convenio
demonstro	demonstro
dimitto	dimitto
doleo	doleo
equitatus	equitatus#2	
felix	felix#1	
frango	frango
gaudium	gaudium
hiberna	hibernus
hospes	hospes
impedio	impedio
impero	impero
infero	infero	
itaque	ita	
iudico	judico
ius	jus
iuvo	juvo
latus	latus#1	
laus	laus
lectus	lectus#2
medius	medius
militaris	militaris	
mirus	mirus
mora	mora#1	
mulier	mulier
multitudo	multitudo
nascor	nascor
nisi	nisi	
noceo	noceo
omnino	omnino
opus	opus#1
orior	orior
parco	parco
patria	patrius#1
pauci	paucus
perturbo	perturbo
potior	potior	
praeter	praeter
quidam	quidam
quisque	quisque
reliquus	reliquus
remus	remus#3	
salus	salus
senator	senator
socius	socius
surgo	surgo
tego	tego
tollo	tollo
tribuo	tribuo
turpis	turpis
ubi	ubi
uter	uter#3
uterque	uter#3
uxor	uxor
vel	vel
vero	verus
virtus	virtus
voluntas	voluntas
@Section 8
absum	absum
accipio	accipio
adsum	adsum
albus	albus
animus	animus
auctoritas	auctoritas
audacia	audacia
aureus	aureus
barbarus	barbarus
bene	bene	
carmen	carmen#1
clamo	clamo
conicio	conicio
coniungo	conjungo
convoco	convoco
cur	cur
delecto	delecto	
difficultas	difficultas
discedo	discedo
dominus	dominus
dormio	dormio
excedo	excedo
expello	expello
fere	fere	
hortus	hortus
iam	jam
inimicus	inimicus
iniuria	injuria	
interim	interim
ita	ita	
labor	labor#2
lapis	lapis
legio	legio
lex	lex
liber	liber#4	
littera	littera
ludus	ludus
mater	mater
miror	miror
narro	narro
natura	natura
necesse	necesse
negotium	negotium
numerus	numerus
nunc	nunc
officium	officium
opinio	opinio
paene	paene
patior	patior
pecunia	pecunia
persuadeo	persuadeo
pervenio	pervenio
poena	poena
populus	populus#1
postea	postea
praemium	praemium
praesidium	praesidium
proelium	proelium
provincia	provincia
reddo	reddo
reduco	reduco
reperio	reperio
rideo	rideo
rogo	rogo	
saepe	saepe	
semper	semper
sic	sic
soror	soror
superior	superus
talis	talis	
tam	tam
tot	tot
tum	tum
verbum	verbum
vereor	vereor
@Section 9
adduco	adduco
adeo	adeo#1	
aequus	aequus
altitudo	altitudo
amplus	amplus
ancora	ancora
apertus	aperio	
armo	armo	
calidus	calidus
certus	certus
claudo	claudo#1	
complures	complures
condicio	condicio
consisto	consisto
conspicio	conspicio#1
cresco	cresco
dexter	dexter
dolor	dolor
efficio	efficio
exerceo	exerceo
exploro	exploro
flos	
frigidus	frigidus
herba	herba
hiemo	hiemo
iaceo	jaceo
idem	idem
nferior	
insidiae	insidiae
integer	integer
interea	interea
latitudo	latitudo
liberi	liberi	
mando	mando#1	
mercator	mercator
murus	murus
nescio	nescio	
nondum	nondum
notus	nosco	
occido	occido#1
opprimo	opprimo
oppugno	oppugno#1	
pareo	pareo
perficio	perficio
pertineo	pertineo
placeo	placeo
potestas	potestas
primum	primus
quo	quo
quot	quot
recipio	recipio
ripa	ripa
rumor	rumor
rumpo	rumpo	
rursus	rursus
sanguis	sanguis
subsidium	subsidium
suscipio	suscipio
sustineo	sustineo
taceo	taceo
tribunus	tribunus
ubi	ubi
umquam	umquam
usus	usus#2	
valles	valles	
vallum	vallum	
@Section 10
accedo	accedo
aeger	aeger
aetas	aetas
aurum	aurum
commoveo	commoveo
communis	communis
comparo	comparo#1
confido	confido
congredior	congredior
contineo	contineo
cupiditas	cupiditas
defero	defero
defessus	de_-fateor
deficio	deficio
descendo	descendo
erro	erro#1	
fio	fio
immortalis	immortalis
impeditus	impedio
inde	inde	
instituo	instituo
item	item	
iudicium	judicium
laetus	laetus#1	
magistratus	magistratus	
mereor	mereor
munitio	munitio
nihil	nihil
ordo	ordo
pilum	pilum	
plebs	plebs
postulo	postulo
praeficio	praeficio
praesum	praesum
praeterea	praeterea
prior	prior
privatus	privo
provideo	provideo
prudens	prudens
quies	quies#1
quisquam	quisquam
quod	qui#1	
ratio	ratio
reicio	reicio
repello	repello
resisto	resisto
sacer	sacer
!simul atque	simul
supra	supra
ultimus	ulter
unde	unde
undique	undique
vix	vix
@Section 11
accido	accido#2
aggredior	aggredior
amicus	amicus#1
arbor	arbor#1
auris	auris	
compleo	compleo
consuetudo	consuetudo
cotidie	cottidie
cupidus	cupidus
cura	cura	
deinde	deinde
desum	desum
diligentia	diligentia
extremus	exter
gloria	gloria	
ibi	ibi
impedimentum	impedimentum
imperium	imperium
incito	incito	
iniquus	iniquus
initium	initium
intermitto	intermitto
ira	ira
iudex	judex
iustus	justus
lingua	lingua
magnitudo	magnitudo
magnopere	magnopere
memoria	memoria
mens	mens
nemo	nemo
numquam	numquam
obses	
oratio	oratio
orbis	orbis	
probo	probo	
propinquus	propinquus
regio	regio	
rus	rus
satis	satis
senex	senex
sententia	sententia
silva	silva
sinister	sinister
statim	statim
stella	stella
studium	studium
tergum	tergum
utor	utor
valeo	valeo
validus	validus
vestis	vestis
victoria	victoria
vita	vita	
@Section 12
bis	bis
captivus	captivus
carrus	carrus
centurio	centurio#2
circiter	circiter	
circumvenio	circumvenio
cohors	cohors
consido	consido
consulo	consulo
cras	cras	
deduco	deduco
disco	disco	
durus	durus
egregius	egregius
emo	emo
enuntio	enuntio
ergo	ergo
expono	expono
forum	forum#1	
heri	heri
hodie	hodie
incipio	incipio
ineo	ineo
inquit	inquam
lacrima	lacrima	
lego	lego#2
ludo	ludo	
maritimus	maritimus
modus	modus
mos	mos
necessarius	necessarius
olim	olim
paulum	paulus#1
pello	pello
permitto	permitto
permoveo	permoveo
poeta	poeta	
praeda	praeda
procul	procul
produco	produco
prope	prope
publicus	publicus
quidem	quidem
recens	recens
reficio	reficio
remitto	remitto
removeo	removeo
renuntio	renuntio	
repente	repens#2	
revertor	revorto
simul	simul
spatium	spatium
sumo	sumo
verus	verus
