#Latin: An Intensive Course, Moreland, Floyd (1977)
@Section 1 
ambulo	ambulo
aqua	aqua
corona	corona
corono	corono
clamo	clamo
cum	cum
cura	cura
de	de#2
do	do#1
dono	dono
ex	ex
enim	enim
et	et
fama	fama
femina	femina	
forma	forma	
hebeo	hebeo
impleo	impleo
en	en
insula	insula#1
nauta	nauta
-ne	
non	non
opto	opto
patria	patrius#1
pecunia	pecunia
poena	poena
poeta	poeta	
porta	porta
-que	
regina	regina
sed	sed
sum	sum#1
taeda	taeda
terreo	terreo
timeo	timeo
via	via	
video	video
@Section 2
ab	ab
ad	ad
anima	anima	
ara	ara	
capio	capio#1	
cella	cella
celo	celo
cogito	cogito	
culpa	culpa	
damno	damno	
dubito	dubito
expello	expello
gloria	gloria
incipio	incipio
incola	incola
incolo	incolo#1
insidiae	insidiae
laboro	laboro
lacrima	lacrima	
luna	luna#1	
moneo	moneo
mora	mora#1	
muto	muto#2	
natura	natura
neque	neque
nec	neque
nihil	nihil
nil	nihil
nisi	nisi	
noxa	noxa
nunc	nunc
pello	pello
per	per
provincia	provincia
puella	puella
semper	semper
sententia	sententia
sentio	sentio
si	si
sub	sub
supero	supero	
taceo	taceo
teneo	teneo
terra	terra
unda	unda	
venio	venio
vita	vita
@Section 3
acerbus	acerbus
ager	ager
audio	audio
bellum	bellum	
bonus	bonus
caecus	caecus#1
campus	campus#3
clarus	clarus
dexter	dexter
dextra	dexter	
diligentia	diligentia	
gero	gero#1	
gladius	gladius
laetus	laetus#1
liber	liber#2	
magnus	magnus#1
malus	malus#1	
Marcus	Marcus#2	
miser	miser
multus	multus
natus	nascor
oculus	oculus
oro	oro
peto	peto
porto	porto
puer	puer
pugno	pugno	
pulcher	pulcher#1
Romanus	Romanus
saxum	saxum
scribo	scribo
servus	servus#2
specto	specto
ut	ut
validus	validus
velum	velum
venia	venia
ventus	ventus
verbum	verbum
vir	vir
@Section 4
aeternus	aeternus
ago	ago
altus	altus#1	
amicus	amicus#1
caelum	caelum#2
carus	carus#1
cibus	cibus
circum	circum	
dea	dea
deleo	deleo
deus	deus
duco	duco
facio	facio
factum	facio	
filia	filia
filius	filius
festus	festus#1
honestus	honestus
inimicus	inimicus
intellego	intellego
lego	lego#2
liber	liber#4	
littera	littera
mensa	mensa	
mitto	mitto
monstro	monstro	
oppidum	oppidum
perdo	perdo
periculum	periculum
pono	pono
quod	qui#1	
regnum	regnum
respondeo	respondeo
studium	studium
tectum	tectum	
tego	tego
trado	trado
umbra	umbra	
urna	urna
verus	verus
villa	villa	
@Section 5
accedo	accedo
ante	ante
antiquus	antiquus
ardeo	ardeo
arma	arma	
aureus	aureus
aurum	aurum
autem	autem
bene	bene	
cano	cano	
cedo	cedo#1
cognosco	cognosco
discedo	discedo
dominus	dominus
durus	durus
ferrum	ferrum
flamma	flamma#1
imperium	imperium
imperio	imperium
impius	impius
interficio	interficio
invado	invado
magister	magister
medius	medius
moveo	moveo
mox	mox
nosco	nosco
novus	novus
numquam	numquam
pius	pius
populus	populus#1
possum	possum
post	post
postquam	postquam
quamquam	quamquam
removeo	removeo
ruina	ruina
ruo	ruo
sine	sine	
socius	socius
tamen	tamen
umquam	umquam
vivo	vivo
voco	voco
@Section 6
ac	atque
atque	atque
animal	animal
Athenae	Athenae
atque	atque
aurora	aurora
careo	careo
corpus	corpus
diu	diu
domus	domus
exemplar	exemplar
exemplum	exemplum
frater	frater
homo	homo
ignis	ignis
Italia	Italia
Iuno	Juno
Iuppiter	Iuppiter
libero	libero
lumen	lumen
mare	mare	
mater	mater
mens	mens
miles	miles
moenia	moenia#1	
mons	mons
nox	nox
oppugno	oppugno#1
pater	pater
rego	rego
rex	rex
Roma	Roma
rumor	rumor
rus	rus
sanus	sanus
scio	scio	
servitus	servitus
sidus	sidus
soror	soror
spargo	spargo#2
timor	timor
urbs	urbs
vigor	vigor
vis	vis	
@Section 7
amo	amo
amor	amor
annus	annus
Asia	Asia#1	
auctor	auctor
civis	civis
conficio	conficio
ego	ego
finis	finis
genus	genus#2
hic	hic
hora	hora#1
hostis	hostis	
ille	ille
inveio	
is	is
locus	locus
meus	meus
mors	mors
noster	noster
odi	odi
opprimo	opprimo
opus	opus#1
perficio	perficio
pes	pes
placeo	placeo
premo	premo
qui	qui#1	
quinque	quin
quis	quis#1	
salus	salus
spero	spero
sui	sui	
suus	suus
tempus	tempus
tu	tu
tuus	tuus
vester	vester
vox	vox
@Section 8
acer	acer#2
carmen	carmen#1
civitas	civitas
dies	dies
dulcis	dulcis
eo	eo#1
felix	felix#1	
fides	fides#1	
fortis	fortis
frigidus	frigidus
fructus	fructus#2
fulgeo	fulgeo
gravis	gravis
iacio	jacio
iacto	jacto
infelix	infelix
ingens	ingens
ira	ira
iubeo	jubeo
libertas	libertas
litus	litus#3
longus	longus
lux	lux
manus	manus#1
memor	memor#1
metus	metus
motus	motus#2	
nomen	nomen
numen	numen
ob	ob
omnis	omnis
opinio	opinio
pectus	pectus
pro	pro#1	
profugus	profugus
publicus	publicus
quaero	quaero
quam	quam	
res	res
saevus	saevus
sensus	sensus#2
species	species	
spes	spes
superus	superus
vertex	vertex
@Section 9
aio	aio
amicitia	amicitia
cado	cado	
casus	casus#2
consilium	consilium
crudelis	crudelis
demens	demens	
difficilis	difficilis
dissimilis	dissimilis
facilis	facilis
gracilis	gracilis
hospes	hospes
humilis	humilis
laudo	laudo
laus	laus
magnopere	magnopere
maior	magnus
male	malus#1
Mars	Mars
multum	multus
munio	munio
nam	nam
odium	odium#1	
parum	parus#1
parvus	parvus
primus	primus
prius	prior
prope	prope
proximus	proximus
saepe	saepe	
sapiens	sapio
sapientia	sapientia
satis	satis
serenus	serenus#1
similis	similis
solvo	solvo
summus	superus
supplex	supplex
tam	tam
templum	templum
tutus	tueor
@Section 10
affero	affero
alius	alius#2
apud	apud
ars	ars
audacia	audacia
audax	audax
aufero	aufero
auxilium	auxilium
certus	certus
coepi	coepio
confero	confero
coniunx	conjunx
custos	custos
defero	defero
differo	differo
doceo	doceo
effero	effero#1
erro	erro#1	
fero	fero	
figura	figura	
foedus	foedus#2
fuga	fuga
fugio	fugio
gaudium	gaudium
gens	gens
iam	jam
incertus	incertus
infero	infero	
iter	iter	
iungo	jungo
mos	mos
nego	nego
neuter	neuter
nullus	nullus
offero	offertor
orbis	orbis	
pars	pars
propter	propter
quantus	quantus
quot	quot
refero	refero#1
signum	signum
sol	sol
solus	solus#1
suffero	suffero
tantus	tantus
tempto	tento
tot	tot
totus	totus#1	
ullus	ullus
unus	unus
uter	uter#3
virtus	virtus
@Section 11
aggredior	aggredior
arbitror	arbitror
ars	ars
audeo	audeo
cena	cena
confiteor	confiteor
conor	conor
consul	consul
credo	credo
cupidus	cupidus
divitiae	divitiae
dux	dux
egredior	egredior
experior	experior
familia	familia
fateor	fateor
flumen	flumen
forum	forum#1	
gradior	gradior
hortor	hortor
imperator	imperator
ingredior	ingredior
iuvenis	juvenis
loquor	loquor
malo	malo	
minor	minor#1	
morior	morior
nascor	nascor
navis	navis
neglego	neglego
nolo	nolo
orator	orator
parens	parens#2
patior	patior
pauper	pauper
praemium	praemium
precor	precor
proficiscor	proficiscor
progredior	progredior
scelus	scelus
sequor	sequor
servo	servo	
soleo	soleo
statua	statua
utor	utor
vereor	vereor
volo	volo#1	
@Section 12
accipio	accipio
an	an
aura	aura	
comes	comes	
copia	copia#1	
cur	cur
deligo	deligo#1
exorior	exorior
expono	expono
horridus	horridus
hostilis	hostilis
idem	idem
immortalis	immortalis
ipse	ipse
iste	iste
iussum	jussum	
maneo	maneo
misereor	misereor
modus	modus
ne	ne#1	
necne	necne
nescio	nescio	
nonne	nonne	
num	num
occulte	occulo	
ops	ops#1
pauci	paucus
posco	posco
quamdiu	quamdiu
quando	quando
quare	quare
quia	quia
quidam	quidam
remaneo	remaneo
rogo	rogo	
sors	sors
tamquam	tamquam
tandem	tandem
ubi	ubi
unde	unde
utinam	utinam
utrum	utrum
@Section 13
admiratio	admiratio
adulescens	adulescens
aliqui	aliqui	
aliquis	aliquis
celer	celer#1	
constituo	constituo
curro	curro
duo	duo
faveo	faveo
fio	fio
heri	heri
hic	hic
ignosco	ignosco
illic	illic#2
iratus	irascor
ius	jus
legatus	lego#1
miror	miror
moror	moror#1	
nemo	nemo
noceo	noceo
oratio	oratio
paene	paene
parco	parco
pareo	pareo
persuadeo	persuadeo
plebs	plebs
praefero	praefero
preaficio	
praesum	praesum
qui	qui#1	
quique	quisque
quisquam	quisquam
quisque	quisque
quo	quo
sollers	sollers
studeo	studeo
usus	usus#2	
vix	vix
@Section 14
accido	accido#2
adeo	adeo#2
advenio	advenio
animus	animus
auctoritas	auctoritas
aut	aut
Carthago	Carthago#1
colloquor	colloquor
dignus	dignus
dolor	dolor
efficio	efficio
etiam	etiam
huc	huc
illuc	illic
indignus	indignus
intendo	intendo
inter	inter
modo	modo	
notus	nosco	
nuntio	nuntio	
nuntius	nuntius
nuper	nuper
os	os#1
ostendo	ostendo
paro	paro#1	
paulus	paulus#1
pax	pax
polliceor	polliceor
propero	propero	
qualis	qualis	
rideo	rideo
senex	senex
sic	sic
talis	talis	
tempestas	tempestas
trans	trans
tum	tum
tunc	tunc
ubique	ubique
veritas	veritas
vinco	vinco
@Section 15
absens	absum
absum	absum
adsum	adsum
agito	agito	
antequam	antequam
appareo	appareo
calamitas	calamitas
contra	contra
cum	cum
desino	desino
donec	donec
dum	dum
dummodo	
etsi	etsi
exiguus	exiguus
exspecto	exspecto
fore	sum#1
futurus	sum#1
fors	fors
fulgor	fulgor
gratus	gratus
igitur	igitur
ingenuim	
inimicitia	inimicitia
interdum	interdum
iudex	judex
iudicium	judicium
memoria	memoria
misceo	misceo
nusquam	nusquam
nutrix	nutrix
occido	occido#2
omnino	omnino
pereo	pereo
priusquam	prior
prosum	prosum
puto	puto	
quamvis	quamvis	
quasi	quasi
quidem	quidem
quoad	quoad
quoniam	quoniam
redeo	redeo
somnus	somnus
supersum	supersum
@Section 16
abeo	abeo
adversus	adversus	
alienus	alienus
amitto	amitto
aperio	aperio
cottidie	cottidie
decorus	decorus
desum	desum
disco	disco
frustra	frustra	
infirmus	infirmus
instituo	instituo
interest	intersum
labor	labor#1	
lex	lex
libenter	libet
licet	licet
miseret	misereo
necesse	necesse
oportet	oportet
paenitet	paeniteo
piget	pigeo
pudet	pudeo
refert	refero
sustineo	sustineo
taedet	taedet
utilis	utilis
vel	vel
vetus	vetus
violo	violo
@Section 17
aetas	aetas
animadverto	animadverto
celeritas	celeritas
defendo	defendo
denique	denique
desisto	desisto
deterreo	deterreo
dubium	dubius
dubius	dubius
impedio	impedio
metuo	metuo
nemus	nemus	
obitus	obitus#3
obsto	obsto
orior	orior
ortus	ortus#3
pervenio	pervenio
prohibeo	prohibeo
quin	quin
quinque	quin
quominus	
radius	radius
religio	religio
relinquo	relinquo
reliquus	reliquus
retego	retego
tergum	tergum
turpis	turpis
una	unus
venor	venor
verto	verto
veto	veto
@Section 18
aestimo	aestimo
as	
cingo	cingo
emo	emo
honor	honor
memini	memini	
nihilum	nihilum
numerus	numerus
obliviscor	obliviscor
pretium	pretium
pugna	pugna	
vendo	vendo
vulnero	vulnero
