#A New Approach to Latin 2, Macnaughton and McDougall (1974)
@Lesson 1
facilis facilis
credo	credo
obviam	obviam
corvus	corvus
praetereo	praetereo
pretium	pretium
emo	emo
vendo	vendo
vicinus	vicinus
invidus	invidus
affirmare	affirmo
disco	disco
edo	edo#1	edo#2	edo#3	
uterque	uter	uter#3
casus	casus#1
@Lesson 2
situs	sino
haud 	haud
procul	procul
!dies natalis	
adeo	adeo#1	adeo#2
novi	nosco	
!pro certo habere	pro#1	pro#2
probus	probus#1
adoptare	adopto
heres	heres
pueritia	pueritia
ago	ago
collis	collis	
silvestris	silvestris
cinctus	cingo
cessare	cesso
cogo	cogo
sumo	sumo
trucidare
undeviginti	
derideo	derideo
@Lesson 3
gratia	gratia
recipere	recipio
divido	divido	
sors	sors
obvenire	obvenio
Oriens	Oriens	
!bellum indico 
superatus	supero
aspis	aspis
admoveo	admoveo
venenum	venenum
triginta	triginta
compono	compono
mandare	mando#1	
quies	quies#1
onerare	onero
cognomen	cognomen
infirmus	infirmus
complures	complures
densus	densus
foras	foras 
petasus	petasus
frigus	frigus
perficio	perficio
incumbo	incumbo
@Lesson 4
culpare	culpo
consulo	consulo
obscurus	obscurus
gelidus	gelidus
pavor	pavor
ruber	
amictus	amictus#2
raucus	raucus
praedicere	praedico#1
lutum	lutum#2	
telum	telum
invisus	invisus#2
frabricare	
intellego	intellego
paulatim	paulatim
aperire	aperio
simplex	simplex
cucumis	cucumis
frictus	frictus#2
caseus	caseus
simplicitas	simplicitas
verecundia	verecundia
cognosco	cognosco
dignus	dignus
@Lesson 5
nuntius	nuntius
concido	concido#1
anhelare	anhelo
ardeo	ardeo
comes	comes	
incendium	incendium
exstinguo	exstinguo
dispergo	dispergo
regio	regio	
vastare	vasto
fumus	fumus
conspicio	conspicio#1
circumire	circumeo
promitto	promitto
interdiu	interdiu
agnosco	agnosco
pectus	pectus
nudare	nudo
dubitare	dubito
cithara	cithara
solarium	solarium#2
fama	fama
@Galilaeus
studiosus	studiosus
volare	volo#2
documentum	documentum
provocare	provoco
tribunal	tribunal
ala	ala
extendo	extendo
insilio	
fragor	fragor
pudor	pudor
tectum	tectum	
deicio	deicio
astrologus	astrologus
magus	magus#2
ut
!in aera
@Lesson 6
@Lesson 7	
diversus
privatus	privatus
late	latus#2	
spargo	spargo#1
violentia	violentia
inertia	inertia
oppidani	oppidani
immobilis	immobilis
usquam	usquam
sipho	sipho
hama	hama
instrumentum	instrumentum
cohibere	cohibeo
amplius	amplus
instituo	instituo
recipere	recipio
iste	iste
factio	factio
modus	modus
vexare	vexo
contraho	contraho
praedium	praedium
moneo	moneo
postulare	postulo
advocare	advoco
@refero
ignorantia	ignorantia
discrimen	discrimen
aetas	aetas
venia	venia
perseverare	persevero
desisto	desisto
obstinatio	obstinatio
proponere	propono
imago	imago
supplicare	supplico
maledicere	maledico
@index
iurare	juro	
furtum	furtum
!fidem fallo	fides#1	fides#2
una	unus
ancilla	ancilla
superstitio	superstitio
pravus	pravus
gravis	gravis
causa	causa
excutio	excutio
crimen	crimen
@Lesson 8
insignis	insignis
beneficium	beneficium
confero	confero
funambulus	funambulus
laedo	laedo
culcita	culcita
dehinc	
subicio	subicio
blandus	blandus
colloqui	colloquor
severus	severus#1
intentus	intendo 
studium	studium
expono	expono
nubo	nubo
dos	dos
aestimare	aestimo
bladiri	
impetrare	impetro
patrimonium	patrimonium
reliquus	reliquus
contentus	contineo
pius	pius
benignus	benignus
revera	re-vero#2
@Lesson 9
praesum	praesum
aegrotare	aegroto
fraus	fraus
recusare	recuso
deliberare	delibero
procrastinare	procrastino
signatus	signo
simul ac	simul
sino	sino	sinum
adire	adeo#1
pridie	pridie
dispono	dispono
poples	poples
succido	succido#2
effugio	effugio	
incolumis	incolumis
!obire mortem	obeo
@contendo
agmen	agmen
crux	crux
coruscus	coruscus
signum	signum
vinco	vinco
proximus	proximus
apparere	appareo	
forma	forma	
!ius iurandum	jus
confirmare	confirmo
@Lesson 10
opulentus	opulentus
fullonica	fullonica
avus	avus
magistratus	magistratus
duodeviginti	
architectura	architectura
!operam dare	opera
educare	educo#2
grammaticus	grammaticus#2
invisus	invisus#2
negotium	negotium
sicut	sicut
libertus	libertus
ratio	ratio
subducere	subduco
curare	curo
suscipio	suscipio
confidere	confido
@prope
nuper	nuper
reficio	reficio
lautus	lavo
pavimentum	pavimentum
tectum	tectum	
ornare	orno
columna	columna
marmoreus	marmoreus
sustineo	sustineo
circumdare	circumdo
aspergo	aspergo#2
amoenus	amoenus
porticus	porticus
cinctus	cingo
praebere	praebeo
frutex	frutex
efficere	efficio
clemens	clemens#1
fidelis	fidelis
felix	felix#1	
@Lession 11
iucundus	jucundus
harena	harena
comitor	comitor
consobrinus	consobrinus
mercator	mercator
amita	amita
proficiscor	
plaustrum	plaustrum
holus	
fructus	fructus#2
ovum	ovum
pullus	pullus#1
macellum	macellum
raeda	raeda
mannus	mannus
raedarius	raedarius
insilio	
veho	veho
gaudium	gaudium
colloquor	colloquor
percontor	percontor
@ingredior
egredior
occurro	occurro
celeritas	celeritas
fur	fur
aufero	aufero
comprehendo	comprehendo
conor	conor
frustra	frustra	
aliquamdiu	aliquamdiu
sequor	sequor
redeo	redeo
caupona	caupona
praetereo	praetereo
bibo	bibo#1	
vendo	vendo
vereor	vereor
conicere	conicio
restituo	restituo
@Lesson 12
lectus	lectus#2
surgo	surgo
os	os#1	os#2
lavo	lavo
cesso	cesso
scelestus	scelestus
sordidatus	sordidatus
vivus	vivus
vigilare	vigilo
audeo	audeo
simul	simul
hilaris	hilaris	
lente	lentus
progredior	progredior
faber	faber#1	
cursus	cursus
certare	certo#2	
uter	uter#3
latratus	latratus
exsilio	
catena	catena
impeditus	impedio
accurrere	accurro
mulcere	mulceo
@hortari
callide
labrum	labrum#2
vestimentum	vestimentum
occulcare	occulco
creta	creta#2	
fricare	frico
conficio	conficio
fames	fames
!valere iubeo	valeo
@Lession 13
caleo	caleo
hora	hora#1
expergiscor	expergiscor
inspicio	inspicio
multitudo	multitudo
aedificium	aedificium
aspectus	aspectus#2
admiror	admiror
scalae	scalae
strepitus	strepitus
conclamare	conclamo
tabernarius	tabernarius
huc	huc
illuc	illic
asinus	asinus
rudo	rudo
gallus	gallus#1
infans
plorare	ploro
hinc	hinc
dubius	dubius
surdus	surdus
pistrina	pistrina
pistor	pistor
@Lesson 14
cubo
cubitum
nondum	nondum
restare	resto
placere	placeo	placo
complures	complures
concurrere	concurro
aufugere	aufugio
illic	illic#2
haereo	haereo
orbita	orbita
rota	rota
agitator	agitator
mulus	mulus
sublata	tollo
onus	onus
trudo	trudo
@Lesson 15
sinister	sinister
palaestra	palaestra
dexter	dexter
officina	officina
vestiarius	vestiarius
lectica	lectica
lecticarius	lecticarius
depono	depono
domina	domina
amphitheatrum	amphitheatrum
palla	palla
laneus	laneus
lana	lana
texo	
vero	verum#2	
veneo	
quadraginta	quadraginta
quinquaginta	quinquaginta
sexaginta	sexa_ginta
denarius	denarius
spoliare	spolio
coccum	coccum
tinctus	tingo
opera	opera	
perdo	perdo
licet	licet
!faber aerarius	faber#1	faber#3
galea	galea
lorica	lorica
@Lesson 16
propter	propter
creber	creber
tremor	tremor
loquor	loquor
quam	quam
stultus	stultus
talis	talis
tablinum	tablinum
recipere	recipio
invitare	invito
brevis	brevis
festus	festus#1
adsentior	ad-sentio
@vicus
eruptio	eruptio
fuga	fuga
abhinc	abhinc
parco	parco
pugna	pugna
damno	damno
orior	orior
vulnerare	vulnero
defero	defero
senatus	senatus
claudo	claudo#1
miror	miror
testula	testula
murus	murus
testula
murus
immemor	immemor
@Lesson 17
perturbare	perturbo
timere	timeo
comitor	comitor
sumo	sumo
ruo	ruo
thermae	thermae
occludo	occludo
placentarius	placentarius
spes	spes
lucrum	lucrum
adduco	adduco
intus	intus
moriturus	morior
respicio	respicio
ater	ater#1
nubes	nubes
magnitudo	magnitudo
species	species	
inusitatus	inusitatus
tumultus
liberi
effundo	effundo
lacrima	lacrima
implorare	imploro
ramosus	ramosus
similis	similis
candidus	candidus
cinis	cinis
obscurare	obscuro
tamquam	tamquam
imber	imber
levis	levis#1	
incipio	incipio
undique	undique
tuba	tuba
periculosus	periculosus
opprimo	opprimo
inclusus	includo
vix	vix
caligo	caligo#1
pulsare	pulso
@Lesson 18
imminere	immineo
sentio	sentio
ut	ut
incido	incido#1
augeo	augeo
consido	consido
quiesco	quiesco
oblitus	obliviscor
solvo	solvo
ne	ne#1	
turba	turba
occido	occido#2
confirmare	confirmo
hilariter	hilaris
tenebrae	tenebrae
sollicitus	sollicitus
adhuc	adhuc
supersum	supersum
sin	sin
modicus	modicus
appono	appono
timor	timor
appeto	appeto#1
praeter	praeter
tabulae	tabula
argentum	argentum
colligo	colligo#1
assiduus
fulgeo	fulgeo
lumen	lumen
luridus	luridus
pareo	pareo
saccus	saccus
nummi	nummus
faveo	faveo
antecedo	
patefacio	patefacio
ancilla	ancilla
obtero	obtero
cumulus	cumulus
obstructus	obstruo
ruina	ruina
trepidatio	
compleo	compleo
pumex	pumex
mixtus	misceo
ululatus	ululatus
quiritatus	quiritatus
aegre	aeger	
@Lesson 19
longius	longus
misereor	misereor
ubique	ubique
postratus	
umerus	umerus
permitto	permitto
reluxit	reluceo
adventans	advento
indicium	indicium
quidem	quidem
lassitudo	lassitudo
excutio	excutio
opertus	operio
tenuatus	tenuo
nebula	nebula
effulgeo	effulgeo
qualis	qualis
deficit	deficio
ploratus	ploratus
planities	
nix	nix
oculus	oculus
occursare	occurso
!prae dolore
vicinus	vicinus
commodare	commodo#2
huc	huc
cisium	cisium
distribuo	distribuo
edo	edo#1	
pulvis	pulvis
appropinquare	appropinquo
salvus	salvus
desilio	
desperare	despero
exitium	exitium
casus	casus#1
@Lesson 20
aper	aper#1
damma	damma
contemno	contemno
iaceo	jaceo
immotus	immotus
segnitia	
offensus	offendo#1
addo	addo
experiri	experior
frango	frango
protinus	protinus
horreo	horreo
villus	villus
intono	intono
adsultare	
recedere	recedo
donec	donec
assidue	assiduus#2
rotare	roto
concido	concido#1
sutrina
devolare
adsuefactus	
sermo	sermo
nominatim	nominatim
notus	notus
manceps	manceps
invidia	invidia
plebs	plebs
consternatio	consternatio
pello	pello
funus	funus
avis	avis
lectus	lectus#2
praecedere	praecedo
tibicen	
genus	genus#1
rogus	rogus
lapis	lapis
construo	
apis
statio
bombus	bombus
universae	universus
praedivinare	praedivino
continere	contineo
tecta	tectum
adulescentia	adulescentia
senior	senex
operari	opero
femur
excipere	excipio
officium	officium
struo	struo
polio	polio#1
suggero	suggero
separatim	separatim
vescor	vesco
inaequalitas	inaequalitas
@Lesson 21
studeo	studeo
quia	quia
quare	quare
complures	complures
pudicus	pudicus
sumptus	sumptus#2
quantulum	quantulus
conduco	conduco
habitatio	habitatio
viaticum	viaticum
impendo	impendo
adicio	adicio
merces	merces#1
conferre	confero
honestus	honestus
praesto	praesto#2
nascor	nascor
infantia	infantia
solum	solum#1	
frequentare	frequento
consuesco	consuesco
tumultus
turbulentus	turbulentus
dolere	doleo
noctu	nox
ei mihi	ei	eum	is
adhuc	adhuc
cristatus	cristatus
gallus	gallus#1
causidicus	causidicus
incus	incus
tundere	tundo
cohibere	cohibeo
sapio	sapio
morbus	morbus
incidere	incido#1
convenire	convenio
opera	opera
@Lesson 22
expendo	expendo
repente	repens#2
par	par
gravitas	gravitas
error	error
indulgeo	indulgeo
severitas	severitas
exemplum	exemplum
admonitus	admoneo
tractare	
evenire
venatio	venatio
inertia	inertia
quies	quies#1
omitto	omitto
venabulum	venabulum
lancea	lancea
vacuus	vacuus
plenus	plenus
contemno	contemno
agitatio	agitatio
motus	motus#2
solitudo	solitudo
cogitatio	cogitatio
incitare	incito
probare	probo
venor	venor
irritare
ignosco	ignosco
sanus	sanus
praesertim	praesertim
opinor	opinor
mollis	mollis
deditus	dedo
sententia	sententia
inanis	inanis
semel	semel
imitari	imitor
identidem	identidem
currus	currus
insisto	insisto
velocitas	velocitas
pannus	pannus
favor	favor
agitator	agitator
clamitare	clamito
prasinus	prasinus
frontem	frons#2
contrahere	contraho
venetus	
@Lesson 23
proscribo	proscribo
lateo	lateo
latebrae	latebra
odoror	odoror
torqueo	torqueo
egregius	egregius
ulterius	
cruciare	crucio
iugulum	jugulum
obicio	obicio
dinosco	dinosco
constans	consto
fides	fides#1	
misericordia	misericordia
quaestio	quaestio
saevitia	saevitia
domesticus
praeda	praeda
occupatus	occupo
dissimulare	dissimulo
subducere	subduco
furtivus	furtivus
egressus	egressus#2
inexpiabilis	inexpiabilis
nota	nota
inuro	inuro
animadverto	animadverto
vestigium	vestigium
voluntarius	voluntarius
cupidus	cupidus
sanguis	sanguis
superiacio	superjacio
crudelitas	crudelitas
poenas	poena
atrox
superbus	superbus
saevus	saevus
memini	memini
fauces	fauces
invado	invado
venter	venter
contundo	contundo
exanimis exanimis
fervens	ferveo
sentire	sentio
effero	effero#1
excipio	excipio
simulare	simulo
recreare	recreo
demonstrare	
diffugere	diffugio
focilare	
ultio	ultio
@Leson 24
infamis	infamis
effigies	effigies
crus	crus
compes	compes#1
gerere	gero#1
quatio	quatio
tristis	tristis
metus	metus
desero	desero#2
monstrum	monstrum
titulus	titulus
intendo	intendo
mens	mens
inanis	inanis
fingo	fingo
initium
ferrum
remittere	remitto
offirmare	offirmo
crebresco	
intra	intra
limen	limen
innuo	innuo
digitus	digitus#1
significare	significo
incumbere	incumbo
insonare	insono
lentus	lentus
gradus	gradus
deflecto	deflecto
area	
folium	folium
indicare	indico#1
effodio	effodio
os	os#2
publice	publicus
sepelio	sepelio
@Lesson 25
coepi	coepio
negare	nego
semis	semis
fallo	fallo
contubernalis	contubernalis
nanciscor	nanciscor
occasio	occasio
hospes	hospes
miliarium	miliarium
luna	luna#1
luceo	luceo
monumentum	monumentum
exuo	exuo
secundum	secundum
pono	pono
lupus	lupus#1
ululare	ululo
accedo	accedo
lapideus	lapideus
stringo
donec	donec
sudor	sudor
artus	artus#2
fluo	fluo
saltem	saltem
pecus	pecus#2	
collum	collum
traicio	traicio
operio	operio
lectulus	lectulus
medicus	medicus	
versipellis	versipellis
gustare	gusto
@Lesson 26
offendo	offendo#1
incautus	incautus
imprudens	imprudens
praeceps	praeceps
brutus	brutus#1
pello	pello
domesticus	domesticus
detineo	detineo
pallidus	pallidus
vultus	vultus
aeger	aeger
pervado	pervado
ascribo	ascribo
contendere	contendo
dimittere	dimitto
iugulare	jugulo
pollex	pollex#1
destinare	destino
percutio	percutio
somnium
ignotus	ignotus#2
humare	humo
conscendere	conscendo
naufragium	naufragium
deverto	deverto
hospes	hospes
hospitium	hospitium
orare	oro
subvenio	subvenio
recumbo	recumbo
quoniam	quoniam
inultus	inultus
patior	patior
supra	supra
faenum	faenum
priusquam	prior
oppidum	oppidum
commoveo	commoveo
bubulcus	bubulcus#1
eruo	eruo
patefacere	patefacio
@Lesson 27
cunctor	cunctor
altitudo	
aquila	aquila#1
contestor	
prodo	prodo
certe	certus
praesto	praesto#2
cohortor	cohortor
dedecus	dedecus
admittere	admitto
subsequor	subsequor
maritimus
efficio	efficio
consuesco	consuesco
incognitus	incognitus
aridum	aridus
subducere	subduco
ancora	ancora
deligare	deligo#2
afflictare	afflicto
frango	frango
funis	funis
armamenta	armamenta
amitto	amitto
inutilis	inutilis
perturbatio	perturbatio
deerant	desum
usui	usus#2
hiemare	hiemo
provideo	provideo
vitrum
gestus	gestus#2
defigo	defigo
demitto	demitto
coniurare	conjuro
adduco	adduco
rebellio	rebellio#1
prohibeo	prohibeo
producere	produco
reditus	redeo	reditus
intercludo	intercludo
adeo	adeo#1	
repello	repello
sustineo	sustineo
vastare	vasto
diripio	diripio
conferre	confero
beneficium	beneficium
fecundus	fecundus
utor	utor
maiores	majores
@Lesson 28
utilis	utilis
ostentare	ostento
tumultus	tumultus
transfuga	transfuga
transvehor	transveho
recipere	recipio
ultra	ultra
adicio	adicio
impono	impono
indomitus
triquetrus	triquetrus
planus	planus#1
benigne	benignus
alo	alo
nemus	nemus
saltus	saltus#2
praegrandis	praegrandis
motus	motus#2	
retro	retro
pelagus	pelagus
fluo	fluo
gemma	gemma	
margarita	margarita
generare	genero
incultus	incultus#1
continens	continens
opes	ops#1
ignarus	ignarus
fines	finis
bigae	bigae
armatus	armo
falcatus	falcatus
axis	axis
@Lesson 29
calidus	calidus
!praefectus portus	praefectus	praefectus#1	praeficio
insolitus	insolitus
pretiosus	pretiosus
caeruleus	
dulcis	dulcis
unguentum	unguentum
suavis	suavis
olfacio	
nasus	nasus#1
luxuria	luxuria	
regia	regia
navigatio	navigatio
gloriosus	gloriosus
splendidus	splendidus
quidem	quidem
instructus	instruo
pratum	pratum	
distinctus	distinguo
gloriari	glorior
concipere	concipio
cista
cachinnus
robustus	robustus
fuscus	fuscus#1
capilli	capillus
revertor	revorto
dispensator	dispensator
opportune	opportunus
studium	studium
invideo	invideo
epulae	epulae
blandus	blandus
ius	jus
modius	modius
maturus	maturus
excogitare	excogito
maturesco	maturesco
@Lesson 30
differo	differo
servitus	servitus
usus	usus#2
contumelia	contumelia
iniuria	injuria
privare	privo
superesse	supersum
impono	impono
vectigal	vectigal
retinere	retineo
affero	affero
malum	malus	
admonere	admoneo
superior	superus
infestus	infestus
lepus	lepus
vulpes	vulpis
genus
regius
spargo	spargo#1
castellum	castellum
consector	consector
expugnare	expugno
praesidium	praesidium
colonia	colonia#1
sedes	sedeo	sedes	sedo
omittere	omitto
propere	properus
fortuna	fortuna	
patientia	patientia
tollo
exuro
felicitas	felicitas#1
socordia	socordia
exuere	exuo
iugum	jugum	
integer	integer
congressus	congressus#2
ostendo	ostendo
sepono	sepono
gens	gens
solvo	solvo
incitamentum	incitamentum
coniunx	conjunx
accendere	accendo#2
exprobrare	exprobro
plerique	plerus
trepidus	trepidus
circumspectare	circumspecto
trado	trado
acies	acies
posteri	posterus
cogitare	cogito
@Lesson 31
frigidus	frigidus
flare	flo
nubilus	nubilus
genu	genu
horrere	horreo
desum	desum
voluptas	voluptas
desiderium	desiderium
fatigare	fatigo
cantus	cantus
unicus	unicus
pugio	pugio
infensus	infensus
remeare	
centuria	centuria
deliciae	deliciae
requiro	requiro
probrum	probrum	
prostratus	prosterno
comitas	comitas	
benevolus	benevolus
iurare	juror
stipendium	stipendium
ridiculus	ridiculus
@Lesson 32
subigo	subigo
provincialis	provincialis
reverentia	reverentia
suscipere	suscipio
urna	urna
aureus	aureus
reliquiae	reliquiae
ultimus	ulter
turbatus	turbo#1
pacatus	
firmus	firmus
imbecillus	imbecillus
proximus
mansio
solum	solus
fundare	fundo#2
animus	animus
volvere	volvo
omen	omen
occurro	occurro
fama	fama
scurra	scurra
clarus	clarus
iocus	jocus
corona	corona
cupressus	cupressus
removere	removeo
color	color
agrestis
discrimen
tutus	tueor
dummodo	
casa	casa
exigo	exigo
messis	messis	
inopia	inopia
esurire	ex-surio
comedo	comedus
cavum	cavum	
tectus	tego
validus	validus
ora	ora#1
circumvenire	circumvenio
insidiae	insidiae
pono	pono
tranquillus	tranquillus
serenus	serenus#1
advesperascit	
fallo	fallo
@Lesson 33
conditio	condicio
regnare	regno
desisto	desisto
ferme	ferme
quadringenti	quadringenti
intra	intra	
vallum	vallum	
commemorare	commemoro
plaga	plaga#2	
meridianus	meridianus
strata	sterno
ibidem	ibidem
testari testor
prior
advehor
terminus	terminus
meto	meto#2
calcare	calco
flebilis	flebilis
penitus	penitus#1
inopinatus	inopinatus
autumnus	auctumnus#1
strages	strages
evadere	evado
fugare	fugo
prius	prior
anniversarius	anniversarius
cogere	cogo
denuntiare	denuntio
ultra	ultra
defensio	defensio
laboriosus	laboriosus
expeditio	expeditio
potius	potis
causa	causa
derelinquere
commodum
trames	trames
ob	ob
quondam	quondam
collocare	colloco
inruptio	
turris	turris
valedico	valedico
confestim	confestim
aquilonalis	
indigena	indigena
capesso	capesso
repello	repello
funus	funus
iugulare	jugulo
mergo	mergo
@Lesson 34
famulus	famulus	
potens	potens
orientalis	orientalis
adplicuit	applico
praecipio	praecipio
mandavit	mando#1
obtemperare	obtempero
dubietas	dubietas
necessaria	necessaria	
ministrare	ministro
vocabulum	vocabulum
resido
divum
colloquium	colloquium
iussio	jussio
promissa	promitto
adsensus	assensus#2
tribuo	tribuo
peregrinus	peregrinus
perspicio	perspicio
communicare	communico
molestus	molestus
benignus	benignus
hospitium	hospitium
victus	victus#2
sociare	socio
@Lesson 35
dono	dono	
antistes	antistes
quamvis	quamvis	
amnis	amnis
peragere	perago
elimosyna	
misericors	misericors
episcopus	episcopus
proprius	proprius
vilis	vilis
donum	donum
sufficio	sufficio
recordari	recordor
conruere	con-ruo
indicare	indico#1
tribuo	tribuo
levare	levo#1	
presbyter	presbyter
lingua	lingua
patrius	patrius#2
domestici	domesticus
rector	rector
dirus	dirus
praesagium	praesagium
impleo	impleo
@Lesson 36
prelatus	
valde	validus
torneamentum	
capellanus	
horae	horae
calcar	calcar
pungo	pungo
triduum	triduum
instruo	instruo
quocienscumque	
saltus	saltus#1
fere	fere
competit	competo
suaviter	suavis	
accidit	accido#2
optatus	opto
@Lesson 37
fabulator	fabulator
contigit	contingo#1
cura	cura
produco	produco
concedo	concedo
solidus	solidus
ovis	ovis
accidit	accido#2
inundatio	
vadum	vadum
exiguus	exiguus
navicula	navicula
obdormire	obdormio
finire	finio
fluctus	fluctus
grex	grex
innumerabilis	innumerabilis
finis	finis
@Lesson 38
mentior	mentior
aenigma	aenigma
invisere	inviso
contulit	confero
vicissim	vicissim
conclave	conclave
impudens	impudens
occupatus	occupo
suaviter	suavis	
torqueo	torqueo
aperte	apertus
atqui	atqui
satietas	satietas
spatium	spatium
consuetudo	consuetudo
convivium	convivium
lusus	lusus#2
prodigus	prodigus
parsimonia	parsimonia
absumo	absumo
candela	candela
detereo	
praeposterus	praeposterus
sapio	sapio
pretiosus	pretiosus
