#Latin Via Ovid (1977)
@Chapter 1
charta  charta
Europa	Europa
fabula	fabula#1
insula	insula#1
paeninsula	paeninsula
puella	puella
regina	regina
terra	terra
est	sum#1
habitat	habito
regnat	regno
spectate	specto
sunt	sum#1
bona	bonus
geographica	geographicus
magna	magnus#1
parva	parvus
prima	primus
pulchra	pulcher#1	
et	et
hic	hic
in	in
ita	ita	
-ne	
non	non
paene	paene
sed	sed
ubi	ubi
@Chapter 2
amica	amicus#2
amicus	amicus#2
deus	deus
filia	filia
Iuppiter	Iuppiter
Ovidius	Ovidius
poeta	poeta	
rex	rex
taurus	taurus#1
Tyrus	Tyrus
amat	amo
desiderat	desidero
fugitat	fugito
ludit	ludo
narrat	narro
portat	porto
spectat	specto
transformat	transformo
nova	novus
timida	timidus
Tyria	Tyrius
ad	ad
cum	cum
de	de#2
diu	diu
nunc	nunc
olim	olim
quis	quis#1	
se	sui
@Chapter 3
agricola	agricola#1
Arachne	Arachne
casa	casa
dea	dea
discipuli	discipulus
incola	incola
lana	lana
Lydia	Lydia	
magister	magister
magistra	magistra	
Minerva	Minerva
nympha	nympha	
pictura	pictura	
sapientia	sapientia
silva	silva
vita	vita
clamat	clamo
dat	do#1
docet	doceo
format	formo
glomerat	glomero
laborat	laboro
laudat	laudo
salve	salvus
vale	valeo
perita	peritus
superba	superbus
bene	bene	
certe	certus
dum	dum
me	ego
quid	quis#1
quod	qui#1
quoque	quo
saepe	saepe	
te	tu
tibi	tu
@Chapter 4
domina	domina
dominus	dominus
experientia	experientia
femina	femina	
forma	forma	
nomen	nomen
superbia	superbia
tela	tela	
affirmo	affirmo
ambulo	ambulo
debeo	debeo
dixit	dico#2
doceo	doceo
esse	sum#1
habeo	habeo
monstro	monstro
nego	nego
quaeso	quaeso
respondeo	respondeo
scribite	scribo
simulo	simulo
tempto	tento
voco	voco
irata	irascor
mea	meus
periculosa	periculosus
stulta	stultus
sua	suus
temeraria	temerarius
etiam	etiam
huc	huc
iterum	iterum
!melius quam	bonus	melius#1
mihi	ego
nemo	nemo
-que	
@Chapter 5
aranea	aranea	
factis	facio
Iuppiter	Iuppiter
misericordia	misericordia
rapina	rapina#1
muto	muto#2	
neco	neco
pendeo	pendeo
prohibeo	prohibeo
bona	bonus
longa	longus
mala	malus#1
minima	parvus
minor	minor#2
optima	bonus
suo	suus
ab	ab
aeterno	aeternus
deinde	deinde
denique	denique
itaque	ita
Latine	Latinus	
maxime	magnus#1	
minime	parvus
neque	neque
optime	bonus	
primo	primus
@Chapter 6
ara	ara
causa	causa
Diana	Diana
donum	donum
fama	fama
familia	familia
filius	filius
flamma	flamma#1
fortuna	fortuna	
Graecia	
Latona	Latona
liberi	liberi
Manto	Manto#1
Niobe	Niobe
oculus	oculus
oppidum	oppidum
Phoebus	Phoebus
potentia	potentia#2
puer	puer
regia	regius
superbia	superbia
templum	templum
Thebae	Thebae	
via	via
circumspecto	circumspecto
moneo	moneo
orno	orno
oro	oro
praesto	praesto#2
rogo	rogo
sto	sto
beatus	beatus	
clarus	clarus
dignus	dignus
multus	multus
sanctus	sancio	
septem	septem
suus	suus
unus	unus
cur	cur
ecce	ecce
ibi	ibi
solum	solus#1
@Chapter 7
aera	aera
campus	campus#2
equus	equus#1
funera	funus
lacrima	lacrima	
mater	mater
moenia	moenia#1
mora	mora#1	
poena	poena
populus	populus#1
querella	querela
ruina	ruina
sagitta	sagitta
schola	schola
statua	statua
verbum	verbum
congelo	congelo
convoco	convoco
exerceo	exerceo
honoro	honoro	
iuvo	juvo
lacrimo	lacrimo
relinquo	relinquo
rogo	rogo	
volo	volo#2	
meus	meus
planus	planus#1
profanus	profanus
ultimus	ulter
ad	ad
celeriter	
hodie	hodie
magis	magnus
o	o
per	per
plus	multus
prope	prope
quot	quot
quam	quam	
satis	satis
tum	tum
ubi	ubi
@Chapter 8
ager	ager
auxilium	auxilium
bracchium	bracchium
cera	cera	
concilium	concilium
fistula	fistula
fuga	fuga	
Pan	
papyrus	papyrus
ripa	ripa
satyrus	satyrus
sonus	sonus#2
Syringa	Syringa
unda	unda	
vir	vir
celo	celo
devoveo	devoveo
erro	erro#1	
fugito	fugito
maneo	maneo
puto	puto	
suspiro	suspiro
teneo	teneo
video	video
benignus	benignus
ceterus	ceterus
densus	densus
miser	miser
nullus	nullus
umbrosus	umbrosus
aeternum	aeternus
autem	autem
donec	donec
eam	is
eos	is
olim	olim
quamquam	quamquam
sic	sic
statim	statim
tamen	tamen
trans	trans
@Chapter 9
Arcadia	Arcadia#1
Arcas	Arcas
caelum	caelum#2
delectamentum	delectamentum
fibula	fibula	
iaculum	jaculum	
ira	ira
Iuno	Juno
Musa	Musa#1	
pretium	pretium
somnus	somnus
!in somno	in
stella	stella	
ursa	ursa
!Ursa Maior	ursa
!Ursa Minor	ursa
vestimentum	vestimentum
victor	victor#1
vitta	vitta
appropinquo	appropinquo
curo	curo
evito	evito#1
iaceo	jaceo
invoco	invoco
retineo	retineo
alius	alius#2
carus	carus#1
formosus	formosus
gratus	gratus
herbosus	herbosus
neglectus	neglego
notus	nosco	
pretiosus	pretiosus
solus	solus#1
aut	aut
cuius	cujus#2
eius	is
propter	propter
secreto	secerno
si	si
@Chapter 10
adultera	adultera
animal	animal
bracchium	bracchium
causa	causa
figura	figura
iniuria	injuria	
matricidium	matricidium
poena	poena
sensa	sentio
tempus	tempus
venator	venator
verbum	verbum
villus	villus
vox	vox
absum	absum
adsum	adsum
expecto	ex-pecto
fugito	fugito
horresco	horresco
servo	servo	
tendo	tendo
transporto	transporto
benignus	benignus
ferus	ferus
humanus	humanus
idoneus	idoneus
immotus	immotus
natus	nascor
pronus	pronus
raucus	raucus
supplex	supplex
territus	terreo
tuus	tuus
vicinus	vicinus
ab	ab
cum	cum
ea	is
post	post
quindecim	
quotiens	quotiens
ter	ter
!ter quinque	ter
@Chapter 11
advena	advena
arbor	arbor#1
Baucis	Baucis
cibus	cibus
dominus	dominus
finis	finis
locus	locus
membrum	membrum
mensa	mensa	
Mercurius	Mercurius
pars	pars
pater	pater
Philomen	
Phrygia	Phrygia	
piscis	piscis
requies	requies
rex	rex
senex	senex
servus	servus#2
stagnum	stagnum#1
vinum	vinum	
dubito	dubito
impero	impero
intro	intro#2
iubeo	jubeo
paro	paro#1	
sedeo	sedeo
venio	venio
apertus	aperio	
clausus	claudo#1
duo	duo
factus	facio	
immensus	immensus
maiorem	magnus
noster	noster
pius	pius
plenus	plenus
verus	verus
ego	ego
enim	enim
et	et
!non procul	non
quicquid	quisquis
ubi	ubi
@Chapter 12
annus	annus
anser	anser#1
cena	cena	
coniunx	conjunx
crater	
custos	custos
homo	homo
miraculum	miraculum
nomen	nomen
os	os#2
praemium	praemium
sacerdos	sacerdos#1
sacrificium	sacrificium
frondeo	frondeo	
prehendo	prehendo
timeo	timeo
vasto	vasto
vivo	vivo	
impius	impius
ipse	ipse
iustus	justus
receptus	recipio
timidus	timidus
eos	is
inter	inter
nos	nos
pro	pro#1	
qui	qui#1	
quoniam	quoniam
semper	semper
sine	sine	
vobis	tu
@Chapter 13
amor	amor
color	color
corpus	corpus
Echo	echo
flos	
flumen	flumen
folium	folium
fons	fons
imago	imago
iuvenis	juvenis
mons	mons
Narcissus	Narcissus#2
nox	nox
potestas	potestas
pudor	pudor
ripa	ripa
soror	soror
spelunca	spelunca
vigor	vigor
vox	vox
desisto	desisto
devoro	devoro
humo	humo	
inquit	inquam
noceo	noceo
paro	paro#1	
pervideo	pervideo
possum	possum
puto	puto	
reporto	reporto
tango	tango
turbo	turbo#2
albus	albus
alius	alius#2
obscurus	obscurus
vester	vester
adhuc	adhuc
antequam	antequam
forte	fors
haec	hic
nemo	nemo
praeter	praeter
pro	pro#1	
quamquam	quamquam	
quem	qui#1	
sui	sui
tamen	tamen
usque	usque
vos	tu	
@Chapter 14
aqua	aqua
arcus	arcus
arma	arma
ars	ars
caput	caput
Copdo	
Daphne	Daphne	
digitus	digitus#1
dolor	dolor
duc	duco
hostis	hostis	
laurus	laurus
manus	manus#1
medicina	medicinus
musica	musica
osculum	osculum
ramus	ramus
sol	sol
telum	telum
Venus	Venus#1
virgo	virgo
vulnus	vulnus
cresco	cresco
dico	dico#2
facio	facio
figo	figo
fugo	fugo
nescio	nescio	
peto	peto
supero	supero	
acutus	acuo	
alter	alter
contentus	contineo
hic	hic
ille	ille
obtusus	obtundo
tuus	tuus
ei	is
is	is
quod	qui#1
tu	tu
@Chapter 15
amans	amo
consilium	consilium
cruor	cruor
domus	domus
fissum	findo	
gladius	gladius
herba	herba
iter	iter	
leo	leo#2
mors	mors
parens	parens#2
paries	paries	
pomum	pomum	
Pyramus	Pyramus#1
radix	radix
tempus	tempus
Thisbe	Thisbe
tumulus	tumulus
velamen	velamen
vestigium	vestigium
bibo	bibo#1	
convenio	convenio
fallo	fallo
fugio	fugio
murmuro	
opto	opto
pervenio	pervenio
quaero	quaero
quaeso	quaeso
relinquo	relinquo
sentio	sentio
traho	traho
venio	venio
albus	albus
cruentus	cruentus
dignus	dignus
prior	prior
purpureus	purpureus
vicinus	vicinus
ex	ex
hinc	hinc
illinc	illinc
procul	procul
qui	qui#1	
quia	quia
recens	recens
sub	sub
ut	ut
utrimque	utrimque
@Chapter 16
cinis	cinis
comes	comes	
hora	hora#1
monumentum	monumentum
periculum	periculum
urna	urna
aperio	aperio
audio	audio
claudo	claudo#1
inquit	inquam
lego	lego#2
mitto	mitto
nomino	nomino
pono	pono
rapio	rapio
incertus	incertus
mortuus	morior	
at	at
atque	atque
nam	nam
non iam	non
quos	qui#1
@Chapter 17
aetas	aetas
audacia	audacia
avus	avus
certamen	certamen
cornu	cornu	
culpa	culpa	
cura	cura	
cursus	cursus
ignis	ignis
lex	lex
Megareus	Megareus#1	
Neptunus	Neptunus
procus	procus#3
rumor	rumor
spectator	spectator
turba	turba	
victoria	victoria
adduco	adduco
capio	capio#1	
corono	corono	
culpo	culpo
damno	damno	
eo	eo#1
ignosco	ignosco
moveo	moveo
scio	scio
sono	sono
supero	supero
vinco	vinco
deterritus	deterreo
durus	durus
innubus	innubus
tantus	tantus
tardus	tardus
victus	vinco	
an	an
forsitan	forsitan
magis	magnus#2
nisi	nisi	
nondum	nondum
qui	qui#1
tam	tam
tardius	tardus
vere	verus
videtur	video
@Chapter 18
auctor	auctor
cursor	cursor#2
Cyprus	Cyprus#1
heros	heros
liber	liber#4
meta	meta	
pagina	pagina
prex	prex
sententia	sententia
signum	signum
tabula	tabula
usus	utor
adduco	adduco
adoro	adoro
carpo	carpo
concino	concino
curro	curro
duco	duco
gaudeo	gaudeo
iacio	jacio
inquit	inquam
posco	posco
praetereo	praetereo
promitto	promitto
scribo	scribo
aureus	aureus
defessus	de_-fateor
invitus	invitus
medius	medius
motus	moveo
remoratus	remoror
summus	superus
tertius	tertius
demum	demum
facile	facilis
forte	fors	
iam	jam
igitur	igitur
interea	interea
longe	longus
magnopere	magnopere
nec	neque
oblique	obliquus
quomodo	quomodo
secreto	secerno	
vix	vix
!hoc modo	hic	huc
@Chapter 19
aurum	aurum
Bacchus	Bacchus#1
caro	caro#2
Ceres	Ceres	
crimen	crimen
dies	dies
maestitia	maestitia
Midas	Midas	
ortus	orior	
postis	postis
res	res
saxum	saxum
venia	venia
vis	vis	
bibo	bibo#1	
credo	credo
edo	edo#1	
fluo	fluo
lavo	lavo
odi	odi	
pecco	pecco
remitto	remitto
removeo	removeo
tendo	tendo
transeo	transeo
adversus	adversus
altus	altus#1	
damnosus	damnosus
liquidus	liquidus
maestus	maestus
omnis	omnis
onustus	onustus
secundus	secundus#1
talis	talis	
viridis	viridis
atque	atque
cum	cum
cupide	cupidus
etiamnunc	
praeterea	praeterea
simul	simul
@Chapter 20
Apollo	Apollo
auris	auris	
carmen	carmen#1
gemma	gemma
iudex	judex
iudicium	judicium
lyra	lyra	
ventus	ventus
abeo	abeo
canto	canto
coepi	coepio
colo	colo#1	
conor	conor
contemno	contemno
decoro	decoro	
desum	desum
effodio	effodio
gero	gero#1
immurmuro	immurmuro
inflo	inflo
libero	libero
loquor	loquor
miror	miror
patior	patior
orior	orior
repono	repono
reseco	reseco
submitto	summitto
taceo	taceo
termino	termino	
vereor	vereor
verto	verto
barbarus	barbarus
dexter	dexter
humanus	humanus
iniustus	injustus
sinister	sinister
villosus	villosus
nam	nam
postea	postea
tum	tum
@Chapter 21
anima	anima	
aura	aura	
Avernus	Avernus
dens	dens
Eurydice	Eurydice
exitus	exitus#2
fatum	fatum	
fax	fax
herba	herba
Hymen	
matrimonium	matrimonium
monstrum	monstrum
nupta	nupto	
nuptiae	nuptiae
omen	omen
orbis	orbis	
Orpheus	Orpheus
passus	passus#4
Pluto	Pluto	
Proserpina	Proserpina
regnum	regnum
serpens	serpens
Styx	
Tartarus	Tartarus#1
umbra	umbra	
accipio	accipio
adeo	adeo#1
affero	affero
ago	ago
ait	aio
audeo	audeo
aufero	aufero
exeo	exeo
fero	fero
invenio	invenio
occido	occido#1
ploro	ploro
recipio	recipio
redeo	redeo
respicio	respicio
retexo	
reverto	revorto
stupeo	stupeo
acer	acer#2
arduus	arduus
avidus	avidus
credelis	
felix	felix#1
geminus	geminus
infelix	infelix
ingens	ingens
mutus	mutus
recens	recens
superus	superus
vanus	vanus
eodem	eodem
frustra	frustra	
protinus	protinus
rursus	rursus
@Chapter 22
animus	animus
ardor	ardor
Baccha	Baccha#1
causa	causa
cervus	cervus
contemptor	contemptor
Erinys	Erinys
hasta	hasta
Hebrus	Hebrus
fides	fides#1
frons	frons#1
Maenas	Maenas	
pectus	pectus
praeda	praeda
tibia	tibia
tympanum	tympanum
umbra	umbra
vates	vates
vellus	vellus
ventus	ventus
dicunt	dico#2
deripio	deripio
doleo	doleo
evenio	evenio
finio	finio
lacero	lacero
mordeo	mordeo
nato	nato	
ploro	ploro
recognosco	recognosco
repello	repello
rubesco	rubesco
tego	tego
!se vertere	sui
soleo	soleo
amoenus	amoenus
diversus	diverto	
innocens	innocens
insanus	insanus#1
peregrinus	peregrinus
supplex	supplex
aliquis	aliquis
ambo	ambo
circum	circum	
en	en
male	malus#1	
quando	quando
seu	sive
ter	ter
tuto	tueor	
velut	velut
@Chaoter 23
Aeetes	Aeetes
Aeson	Aeson
Argonautae	Argonautae
Argus	Argus
aries	
calceus	calceus
Colchis	Colchis	
Delphi	Delphi
draco	draco
Iason	Iason
Medea	Medea
navis	navis
negotium	negotium
nuntius	nuntius
oraculum	oraculum
Pelias	Pelias#2	
Phrixus	Phrixus
Pythia	Pythia	
Thessalia	Thessalia	
vellus	vellus
aedificio	aedificium
amitto	amitto
appello	appello#1
aro	aro	
confero	confero
conscendo	conscendo
creo	creo
deligo	deligo#1	
edo	edo#2	
egredior	egredior
expello	expello
fingo	fingo
gero	gero#1	
induo	induo
intereo	intereo
iungo	jungo
morior	morior	
nuntio	nuntio	
obtineo	obtineo
occido	occido#1
potior	potior	
refero	refero
retineo	retineo
solvo	solvo
spargo	spargo#2
spero	spero
spiro	spiro
trado	trado
armatus	armo
brevis	brevis
fidelis	fidelis
nonnullus	nonnullus
paucus	paucus
quidam	quidam
scelestus	scelestus
ullus	ullus
cras	cras	
heri	heri
hodie	hodie
ob	ob
umquam	umquam
@Chapter 24
Aesonides	Aesonides
ars	ars
Charybdis	Charybdis
ferrum	ferrum
furor	furor#2
germana	germanus#1
iussum	jussum	
mens	mens
nata	nata	
nubes	nubes	
ops	ops#1
ratio	ratio
Scylla	Scylla
servatrix	servatrix
tellus	tellus
testis	testis
tigris	tigris
timor	timor
velum	velum
virtus	virtus
arbitror	arbitror
committo	committo
concipio	concipio
concurro	concurro
exhortor	exhortor
existimo	existimo
exstinguo	exstinguo
fateor	fateor
gravo	gravo
metuo	metuo
nascor	nascor
navigo	navigo
nosco	nosco
obsto	obsto
pereo	pereo
praepono	praepono
probo	probo	
repugno	repugno
sequor	sequor
suadeo	suadeo
subvenio	subvenio
deterior	deterior
ingratus	ingratus
melior	bonus
nefarius	nefarius
saevus	saevus
salvus	salvus
antea	antea
apud	apud
ergo	ergo
heu	heu
intra	intra
modo	modo	
nescio	nescio	
nihil	nihil
priusquam	prior
@Chapter 25
Aesonides	Aesonides
aratrum	aratrum
bellum	bellum	
carmen	carmen#1	
clamor	clamor
dextra	dexter	
fumus	fumus
galea	galea
Hecate	Hecate
humus	humus
iugum	jugum
Lethe	Lethe	
Mars	Mars
medicamen	medicamen
promissus	promissus#2
sceptrum	sceptrum
semen	semen
spolium	spolium
umerus	umerus
uxor	uxor
vultus	vultus
agere	ago
ardeo	ardeo
cado	cado
coepi	coepio
converto	converto
disco	disco	
efflo	efflo
effugio	effugio	
excipio	excipio
fio	fio
mollio	mollio
palleo	palleo
recedo	recedo
supersum	supersum
aeneus	aeneus
eburneus	
exstinctus	
ferreus	ferreus
fixus	figo
frigidus	frigidus
gravis	gravis
horrendus	horreo
Lethaeus	Lethaeus
magicus	magicus
mirus	mirus
obvius	obvius
pervigilis	
placidus	placidus
posterus	posterus
secretus	secerno
tantus	tantus
terribilis	terribilis
triformis	triformis
tutus	tueor
ipse	ipse
magis	magis#3	
quisque	quisque
subito	subeo	
tam	tam
tot	tot
@Chapter 26
aenus	aenus#3
ala	ala	
barba	barba#1
currus	currus
ensis	ensis
fossa	fossa	
gradus	gradus
guttur	guttur
Iuventus	juventus
lac	lac
lapis	lapis
luna	luna#1	
manes	manes	
membrana	membrana
modus	modus
munus	munus
odor	odor
oliva	oliva	
opus	opus#1
Oriens	Oriens	
ovis	ovis
ovum	ovum
pallor	pallor
pecunia	pecunia
pietas	pietas#1
prex	prex
salus	salus
sanguis	sanguis
senectus	senectus#2
sepulchrum	sepulcrum
spatium	spatium
sucus	sucus
sulphur	
valvae	valvae
volucris	volucris
addo	addo
albeo	albeo
ascendo	ascendo
circumeo	circumeo
coeo	coeo
confiteor	confiteor
conicio	conicio
dormio	dormio
effundo	effundo
mico	mico
misceo	misceo
perfundo	perfundo
experior	experior
recipio	recipio
reddo	reddo
repleo	repleo
revoco	revoco
seco	seco
transmitto	transmitto
tremesco	tremesco
visito	visito	
vulnero	vulnero
aequus	aequus
ater	ater#1
calidus	calidus
collectus	colligo#1
extremus	extremus	
fidus	fidus#1
niger	niger
nudus	nudus
pennatus	pennatus	
strictus	stringo
validus	validus
vetus	vetus
ergo	ergo
graviter	gravis	
quo	quo
simul	simul
tandem	tandem
@Chapter 27
Aegeus	Aegeus#1	
Aegides	Aegides	
aethra	aethra#1
Athenienses	Atheniensis	
clava	clava	
Eleusina	Eleusina	
hospes	hospes
isthmus	
latro	latro#3
lectus	lectus#2	
Neptunus	Neptunus
ora	ora#1	
peregrinator	peregrinator
pinus	
Pittheus	Pittheus
Procrustes	Procrustes
proles	proles
regio	regio	
rus	rus
Sciron	Sciron#1	
Sinis	Sinis	
solea	solea
sus	sus
Theseus	Theseus
Troezen	
turtur	turtur
tyrrannus	
votum	votum	
Vulcanus	Volcanus
apto	apto	
aro	aro	
curvo	curvo	
demitto	demitto
discedo	discedo
expono	expono
inclino	inclino
occido	occido#1	
offero	offertor
persuadeo	persuadeo
proficiscor	
recuso	recuso
suscipio	suscipio
terreo	terreo	
tollo	tollo
traditur	trado
utor	utor
aptus	aptus
ferreus	ferreus
idoneus	idoneus
publicus	publicus
puerilis	puerilis
Troezenius	Troezenius
securus	securus
similis	similis
solutus	solvo
quam	quam	
quis	quis#1	
secundum	secundum	
valde	validus
@Chapter 28
Androgeus	
Cerberus	Cerberus
convivium	convivium
Creta	Creta#1	
facinus	facinus
foedus	foedus#2
genus	genu	
hospitium	hospitium
labyrinthus	labyrinthus
latratus	latratus	
Minos	Minos
Minotaurus	Minotaurus
nebula	nebula
nefas	nefas
nex	
plausus	plausus#3
poculum	poculum
spuma	spuma	
thalamus	thalamus
venenum	venenum
voluptas	voluptas
abicio	abicio
accendo	accendo#2
celebro	celebro
interficio	interficio
invito	invito	
paco	
pateo	pateo
procreo	procreo
sacrifico	sacrifico	
albus	albus
biformis	biformis
bimaris	bimaris
celeber	celeber
ferox	ferox
ignarus	ignarus
patrius	patrius#1
potens	possum
tristis	tristis
quam	quam	
quin	quin
@Chapter 29
adulterium	adulterium
anulus	anulus#1	
Ariadna	Ariadna
beneficium	beneficium
camera	camera	
Daedalus	Daedalus#2	
Dia	Dia	
Dionysus	Dionysus
error	error
fallacia	fallacia
fetus	fetus#2
filum	filum
flexus	flexus#3
fortitudo	fortitudo
frons	frons#2
ianua	janua
lapsus	lapsus#3
lignum	lignum
limen	limen
lumen	lumen
Maeandrus	
Naxos	Naxos
Nereus	
opprobrium	opprobrium
opus	opus#1
Pasiphae	
patria	patrius#2
socius	socius
sors	sors
uterus	uterus
voluntas	voluntas
conservo	conservo	
constituo	constituo
construo	construo
decipio	decipio
dimitto	dimitto
evolvo	evolvo
foret	foro
libet	libet	
licet	licet
ligo	ligo#1	
occurro	occurro
oportet	oportet
pasco	pasco	
placet	placeo	
propono	propono
punio	punior
queror	queror
refluo	refluo
revenio	revenio
submergo	sub-mergo
desertus	desero#2
discors	discors
foedus	foedus#1
multiplex	multiplex
perennis	perennis
Phrygius	Phrygius
regalis	regales
saevus	saevus
subitus	subeo
varius	varius#1	
aliter	aliter
ambo	ambo
bis	bis
crudeliter	crudelis
mox	mox
!non aliter	non
propius	propius
protinus	protinus
quam	quam	
@Chapter 30
Amazon	Amazon
arx	arx
auspicium	auspicium
Calydon	Calydon
canis	canis#2	
cogitatio	cogitatio
exsilium	exsilium
furor	furor#2
Hippolyta	Hippolyta
Hippolytus	Hippolytus
ius	jus
laetitia	laetitia
libertas	libertas
Meleager	
moenia	moenia#1
Oedipus	
pastor	pastor
Pirithous	Pirithous
princeps	princeps
proelium	proelium
sanguis	sanguis
sanitas	sanitas
sus	sus
tributum	tribuo	
tus	
venatrix	venatrix
cogo	cogo
commoveo	commoveo
habeor	habeo
imploro	imploro
malo	malo	
nolo	nolo
obliviscor	obliviscor
pario	pario#2	
volo	volo#1	
lamentabilis	lamentabilis
sapiens	sapio
sepultus	sepelio
contra	contra
imprimis	imprimo
iuxta	juxta
!non iam	non
