#Oxford Latin Course Part 2 (1987)
@Section 1
spero	spero
edo	edo#1	
cresco	cresco
conficio	conficio
conspicio	conspicio#1
incipio	incipio
ineo	ineo
bibo	bibo#1	
pello	pello
propello	propello
propuli	propello
relinquo	relinquo
surgo	surgo
verto	verto
cibus	cibus
classis	classis
mons	mons
vivus	vivus
dexter	dexter
sinister	sinister
felix	felix#1	
super	super#2	
qui	qui#1	
quam	quam	
autem	autem
@Section 2
salus	salus
ars	ars
dubius	dubius
notus	nosco	
nobilis	nobilis
incolumis	incolumis
ullus	ullus
vix	vix
paene	paene
quamquam	quamquam	
extra	extra	
post	post
postea	postea
postquam	postquam
volo	volo#1	
@Section 3
dubito	dubito
taceo	taceo
fero	fero	
affero	affero
refero	refero
occurro	occurro
aspicio	aspicio
conspicio	conspicio#1
inspicio	inspicio	
despicio	despicio
respicio	respicio
prospicio	prospicio
causa	causa
fama	fama
turba	turba	
locus	locus
praemium	praemium
aetas	aetas
os	os#1	
adventus	adventus
laetus	laetus#1	
gratus	gratus
summus	superus
dulcis	dulcis
plus	multus
hodie	hodie
cotidie	cottidie
postridie	postridie
modo	modo	
propter	propter
@Section 4
aedificio	aedificium
deleo	deleo
caedo	caedo
occido	occido#1	
cano	cano	
insum	insum
nolo	nolo
moenia	moenia#1	
honor	honor
sanguis	sanguis
rus	rus
latus	latus#1	
sacer	sacer
crudelis	crudelis
circum	circum	
ab	ab
abhinc	abhinc
adhuc	adhuc
hic	hic
huc	huc
hinc	hinc
ille	ille
illic	illic#2
illuc	illic
illinc	illinc
@Section 5
curo	curo
doceo	doceo
traho	traho
evado	evado
custodio	custodio
gloria	gloria	
exemplum	exemplum
finis	finis
oratio	oratio
senex	senex
libertas	libertas	
multitudo	multitudo
senatus	senatus
fides	fides#2	
periculosus	periculosus
idem	idem
ipse	ipse
nuper	nuper
plus	multus
@Section 6
volo	volo#2	
ardeo	ardeo
valeo	valeo
consisto	consisto
iungo	jungo
coniungo	conjungo
tego	tego
nolo	nolo
ne	ne#1	
victoria	victoria
modus	modus
silentium	sileo
pes	pes
aestas	aestas
ignis	ignis
vestis	vestis
genus	genu	
cursus	cursus
divinus	divinus
humanus	humanus
ultimus	ulter
@Section 7
comparo	comparo#1	
iuvo	juvo
occupo	occupo
perterreo	perterreo
habeo	habeo
cogo	cogo
corripio	corripio
sino	sino	sinum
conficio	conficio
efficio	efficio
interficio	interficio
perficio	perficio
reficio	reficio
fortuna	fortuna
villa	villa	
amicus	amicus#2
inimicus	inimicus
copiae	copia#1
dux	dux
eques	eques
hiems	hiems
miles	miles	
vesper	
sapiens	sapio
quoque	quo
sub	sub
@Section 8
conor	conor
videor	video
loquor	loquor
sequor	sequor
proficiscor	proficiscor
morior	morior	
patior	patior
egredior	egredior
ingredior	ingredior
progredior	progredior
regredior	regredior
imperium	imperium
imperator	imperator
postula	postulo
praebeo	praebeo
legatus	lego#1
scutum	scutum
mos	mos
durus	durus
ferox	ferox
quidam	quidam
quot	quot
mille	mille
milia	mille
diu	diu
@Section 9
erro	erro#1	
obsideo	obsideo
claudo	claudo#1
includo	includo
curro	curro
concurro	concurro
procurro	procurro
colligo	colligo#1
mitto	mitto
dimitto	dimitto
parco	parco	
cupio	cupio
memoria	memoria
barbarus	barbarus
factum	facio	
mulier	mulier
virtus	virtus
plus	multus
superbus	superbus
acer	acer#2
frustra	frustra	
magnopere	magnopere
multum	multus
@Section 10
comprehendo	comprehendo
!pedem refero	pedis	pedo#1	pes
pereo	pereo
audacia	audacia
fabula	fabula#1
forma	forma	
fuga	fuga	
socius	socius
praesidium	praesidium
custos	custos
cupiditas	cupiditas
mens	mens
clades	clades
acriter	acer#2
diligens	diligens
infelix	infelix
mirus	mirus
ullus	ullus
num	num
an	an
deinde	deinde
qua	qua	
@Section 11
dubito	dubito
veto	veto
expello	expello
ignosco	ignosco
perdo	perdo
prodo	prodo
premo	premo
aufero	aufero
impedio	impedio
nescio	nescio	
causa	causa
ingenium	ingenium
civitas	civitas
mens	mens
magistratus	magistratus	
dignus	dignus
dives	dives
divitiae	divitiae
ignavus	ignavus
vehemens	vehemens
pauper	pauper
aliquis	aliquis
quomodo	quomodo
paulum	paulus#1
ex	ex
@Section 12
excito	excito
desidero	desidero
accidit	accido#1
arcesso	arcesso
confugio	confugio	
effugio	effugio	
solvo	solvo
sumo	sumo
veho	veho
moror	moror#1	
labor	labor#1	
queror	queror
pecunia	pecunia
exsilium	exsilium
fatum	fatum	
officium	officium
otium	otium
negotium	negotium
limen	limen
caedes	caedes	
purus	purus
antiquus	antiquus
levis	levis#1	
mortalis	mortalis
immortalis	immortalis
satis	satis
cotidie	cottidie
postridie	postridie
meridies	meridies
abhinc	abhinc
apud	apud
deus	deus
@Section 13
delecto	delecto	
dono	dono	
donum	donum
redono	redono
porto	porto
noceo	noceo
agnosco	agnosco
posco	posco
sumo	sumo
tango	tango
sentio	sentio
miror	miror
admiror	admiror
colloquor	colloquor
elabor	elabor
amicitia	amicitia
frumentum	frumentum
avis	avis	
latus	latus#2	
miles	miles	
militia	militia
militaris	militaris	
ver	
reditus	reditus
insignis	insignis
qualis	qualis	
rursus	rursus
alter	alter	
uterque	uter#3
@Section 14
celo	celo
doleo	doleo
excipio	excipio
contemno	contemno
rumpo	rumpo	
irrumpo	irrumpo
erumpo	erumpo
tollo	tollo
nascor	nascor
orior	orior
desum	desum
toga	toga
tergum	tergum
pectus	pectus
fors	fors
gens	gens
casus	casus#2
honestus	honestus
indignus	indignus
privatus	privo
purus	purus
turpis	turpis
quia	quia
ut	ut
sicut	sicut
ac	atque
@Section 15
certo	certo#2	
certamen	certamen
lavo	lavo
augeo	augeo
fundo	fundo#1	
diffundo	diffundo
neglego	neglego
fio	fio
hortor	hortor
irascor	irascor
patior	patior
fruor	fruor
audeo	audeo
gaudeo	gaudeo
soleo	soleo
confido	confido
hora	hora#1
inopia	inopia
umbra	umbra	
legatus	lego#1
auctoritas	auctoritas
ordo	ordo
viator	viator
gratus	gratus
nondum	nondum
donec	donec
@Section 16
aestimo	aestimo
despero	despero
desperatio	desperatio
nego	nego
simulo	simulo	
exerceo	exerceo
invideo	invideo
invidia	invidia
mereo	mereo	
fluo	fluo
viso	viso	
malo	malo	
auris	auris	
iudex	judex
ius	jus
passus	passus#4
regio	regio	
sermo	sermo
vicinus	vicinus
improbus	improbus
tranquillus	tranquillus
numquam	numquam
umquam	umquam
nonnunquam	
nil	nihil
simul	simul
denique	denique
at	at
ita	ita
@Section 17
colloco	colloco
accuso	accuso
existimo	existimo
obsideo	obsideo
amitto	amitto
dedo	dedo
deditio	deditio
incendo	incendo
incendium	incendium
instruo	instruo
vereor	vereor
captivus	captivus
morbus	morbus
nubes	nubes	
occasio	occasio
pedes	pedes
pedites	pedito
orbis	orbis	
agmen	agmen
scelus	scelus
fluctus	fluctus
impetus	impetus
acies	acies
vis	vis	
vires	vis
falsus	fallo
humanus	humanus
reliquus	reliquus
aeger	aeger
modo	modo
@Section 18
cogito	cogito	
careo	careo	
fallo	fallo
metuo	metuo
metus	metus
ruo	ruo
irruo	irruo
munio	munio
precor	precor
suspicor	suspicor
polliceor	polliceor
fruor	fruor
utor	utor
prosum	prorsum	
coepi	coepio
odi	odi	
disciplina	disciplina
poena	poena
insidiae	insidiae
exemplum	exemplum
supplicium	supplicium
vallum	vallum	
venenum	venenum
adulescens	adulescens
turris	turris
invitus	invitus
idoneus	idoneus
proximus	proximus
tardus	tardus
@Section 19
confirmo	confirmo
muto	muto#2	
excipio	excipio
committo	committo
obliviscor	obliviscor
memini	memini	
praeda	praeda
provincia	provincia
vulgus	vulgus
finis	finis
fines	finis
frigus	frigus
potestas	potestas
potens	possum	
quies	quies#1
maiores	magnus	
currus	currus
frequens	frequens
similis	similis
ob	ob
praeter	praeter
praetereo	praetereo
praeterveho	praetervehor
@Section 20
regno	regno	
habeo	habeo
desino	desino
volvo	volvo
minor	minor#1	
minax	minax
suscipio	suscipio
aura	aura	
lingua	lingua
chorus	chorus
frigus	frigus
frigidus	frigidus
pietas	pietas#1
quies	quies#1
religio	religio
ratio	ratio
sanctus	sancio	
recens	recens
quoniam	quoniam
prope	prope
supra	supra
ultra	ultra
