#Oxford Latin Course Part 1 (1987)
@Section 1
parat	paro#1	
vocat	voco
intrat	intro#2
iuvat	juvo
salutat	saluto
laborat	laboro
puella	puella
cena	cena
ianua	janua
puer	puer
filia	filia
non	non
et	et
sed	sed
ad	ad
@Section 2
audit	audio
redit	redeo
videt	video
venit	venio
filius	filius
ager	ager
eum	is
@laudat
dicit	dico#2
via	via	
fessus	fessus
bonus	bonus
@Section 3
iacet	jaceo
timet	timeo
adit	adeo#1
dormit	dormio
fugit	fugio
mittit	mitto
quaerit	quaero
silva	silva
canis	canis#1	
malus	malus#1	
tutus	tueor
nam	nam
mox	mox
iam	jam
diu	diu
@Section 4
clamat	clamo
exspectat	exspecto
festinat	festino
rogat	rogo
manet	maneo	
respondet	respondeo
aqua	aqua
ascendit	ascendo
descendit	descendo
currit	curro
ducit	duco
petit	peto
capit	capio#1
valde	validus
laetus	laetus#1	
magnus	magnus#1
territus	terreo
@Section 5
specto	specto
doceo	doceo
iacio	jacio
accedo	accedo
scribo	scribo
facio	facio
advenio	advenio
inquit	inquam
amicus	amicus#2
ludus	ludus
magister	magister
domus	domus
alius	alius#2
iratus	irascor
celeriter	
tam	tam
quid	quis#1	
cur	cur
@Section 6
pugno	pugno	
oppugno	oppugno#1
navigo	navigo
vinco	vinco
adsum	adsum
mortuus	morior	
multus	multus
fortis	fortis
fortiter	fortis	
omnis	omnis
tristis	tristis
ille	ille
tandem	tandem
porta	porta	
pugna	pugna	
ira	ira
terra	terra
navis	navis	
rex	rex
urbs	urbs
princeps	princeps
celer	celer#1	
diligens	diligens
fortiter	fortis	
diligenter	diligenter
@Section 7
ceno	ceno
moneo	moneo
gaudeo	gaudeo
habeo	habeo
interficio	interficio
convenio	convenio
insula	insula#1
murus	murus
equus	equus#1
vir	vir
collis	collis	
hostis	hostis	
nox	nox
parvus	parvus
totus	totus#1	
tacitus	taceo
ibi	ibi
iterum	iterum
saepe	saepe	
quod	qui#1	
@Section 8
constituo	constituo
cupio	cupio
debeo	debeo
iubeo	jubeo
habito	habito
accipio	accipio
servo	servo	
terreo	terreo	
somnus	somnus
deus	deus
comes	comes	
dies	dies
homo	homo
labor	labor#2
solus	solus#1
miser	miser
ingens	ingens
subito	subeo	
inter	inter
et	et
semper	semper
hic	hic
quo	quo
@Section 9
possum	possum
regina	regina
unda	unda	
nuntius	nuntius
ventus	ventus
senex	senex
tempestas	tempestas
novus	novus
unus	unus
tantus	tantus
ceteri	ceterus
prope	prope
statim	statim
sic	sic
dum	dum
ubi	ubi
semper	semper
interea	interea
@Section 10
amo	amo
rego	rego
amor	amor
animus	animus
gladius	gladius
servus	servus#2
meus	meus
tuus	tuus
etiam	etiam
nunc	nunc
aut	aut
post	post
de	de#2
@Section 11
curo	curo
do	do#1	
tempto	tento
cado	cado	
discedo	discedo
ostendo	ostendo
procedo	procedo
reddo	reddo
fero	fero	
femina	femina	
flos	
frater	frater
pars	pars
pulcher	pulcher#1
gravis	gravis
nullus	nullus
duo	duo
contra	contra
cum	cum
mecum	ego
tecum	tu
itaque	ita	
nec	neque
@Section 12
oro	oro
contendo	
gero	gero#1	
pono	pono
agricola	agricola#1
familia	familia
gloria	gloria	
copiae	copia#1
populus	populus#1	
oppidum	oppidum
vinum	vinum	
arma	arma	
castra	castra	
centurio	centurio#2
legio	legio
miles	miles
mors	mors
opus	opus#1
parens	parens#2	
exercitus	exercitus#3
primus	primus
sacer	sacer
ante	ante
ubi	ubi
domus	domus
cum	cum
@Section 13
narro	narro
sto	sto
moveo	moveo
commoveo	commoveo
fleo	fleo
ineo	ineo
disco	disco	
vendo	vendo
vivo	vivo	
argentum	argentum
uxor	uxor
saevus	saevus
verus	verus
verum	verus
nihil	nihil
tum	tum
paratus	paro#1	
territus	terreo
armatus	armo
commotus	commoveo
@Section 14
audeo	audeo
absum	absum
lego	lego#2
invenio	invenio
luna	luna#1	
locus	locus
civis	civis
lux	lux
arbor	arbor#1
iter	iter	
longus	longus
tantus	tantus
audax	audax
numquam	numquam
procul	procul
hodie	hodie
postridie	postridie
bene	bene	
sub	sub
@Section 15
ago	ago
emo	emo
aperio	aperio
oculus	oculus
Iuppiter	Iuppiter
iuvenis	juvenis
forum	forum#1	
templum	templum
altus	altus#1	
summus	superus
carus	carus#1
medius	medius
vetus	vetus
pauper	pauper
primum	primus
deinde	deinde
antea	antea
hic	hic
illic	illic#2
@Section 16
intellego	intellego
punio	punior
rideo	rideo
studeo	studeo
scio	scio	scius
littera	littera
liber	liber#4	
senator	senator
manus	manus#1
nemo	nemo
facilis	facilis
difficilis	difficilis
gravis	gravis
pauci	paucus
@Section 17
puto	puto	
supero	supero	
ludo	ludo	
conficio	conficio
epistola	epistula
dominus	dominus
campus	campus#3
consul	consul
victor	victor#1
orator	orator
pes	pes
vox	vox
latus	latus#1	
clarus	clarus
alii	alius#2	
quis	quis#1	
quo	quo
eo	eo#2	
quantus	quantus
tantus	tantus
@Section 18
teneo	teneo
desero	desero#2
pono	pono
nosco	nosco
tollo	tollo
conspicio	conspicio#1
inspicio	inspicio	
poeta	poeta	
annus	annus
auxilium	auxilium
carmen	carmen#1	
lex	lex
oratio	oratio
hiems	hiems
olim	olim
@Section 19
libero	libero
accuso	accuso
vulnero	vulnero
prohibeo	prohibeo
incendo	incendo
rapio	rapio
patria	patrius#1
toga	toga
saxum	saxum
soror	soror
caput	caput
corpus	corpus
alter	alter	
ubi	ubi
ubique	ubique
ibi	ibi
unde	unde
unde	unde
undique	undique
inde	inde	
pro	pro#1	
trans	trans
undecim
duodecim
tredecim	
quattuordecim	
sedecim	
septendecim	
duodeviginti	
undeviginti	
viginti	viginti
@Section 20
impero	impero
colo	colo#1	
promitto	promitto
relinquo	relinquo
lacrima	lacrima	
mora	mora#1	
vita	vita	
numerus	numerus
ferrum	ferrum
proelium	proelium
signum	signum
verbum	verbum
sol	sol
pax	pax
portus	portus
manus	manus#1
aequus	aequus
plenus	plenus
brevis	brevis
prudens	prudens
numquam	numquam
umquam	umquam
si	si
sine	sine	
