#Essentials of Latin, Richards, John. (1958)
@Lesson 1
Academia	academia
Africa	Africa	
agricola	agricola#1
America	
cras	cras	
et	et
Europa	Europa	
filia	filia
Graecia	
heri	heri
hodie	hodie
in	in
ita	ita	
Italia	Italia
minime	parvus
nauta	nauta
-ne	
non	non
nostra	noster
puella	puella
Roma	Roma
schola	schola
silva	silva
sum	sum#1
ubi	ubi
via	via	
@Lesson 2
amicus	amicus#2
amo	amo
aqua	aqua
cibus	cibus
cui	quis#1
do	do#1	
dominus	dominus
donum	donum
equus	equus#1
erro	erro#1	
exspecto	exspecto
hortus	hortus
luna	luna#1
monstro	monstro
mox	mox
patria	patrius#2
pecunia	pecunia
porto	porto
-que	
quid	quis#1	
quis	quis#1	
semper	semper
servus	servus#2
specto	specto
stella	stella	
taurus	taurus#1
vacca	vacca#1
@Lesson 3
ad	ad
ager	ager
audio	audio
duco	duco
emo	emo
filius	filius
frumentum	frumentum
in	in
liber	liber#4	
magister	magister
mitto	mitto
moneo	moneo
navigo	navigo
oppidum	oppidum
pono	pono
praemium	praemium
puer	puer
quo	quo
rego	rego
reperio	reperio
scribo	scribo
templum	templum
venio	venio
verbum	verbum
video	video
@Lesson 4
Americanus	
bonus	bonus
Brittania	Britannia
Corsica	Corsica	
Creta	Creta#1	
delecto	delecto	
diu	diu
femina	femina	
fidus	fidus#1
habeo	habeo
habito	habito
honestus	honestus
insula	insula#1
laudo	laudo
liber	liber#2	
liberi	liber#3
magnus	magnus#2
maneo	maneo
Marcus Tullius	Marcus#2	marcus#1
meus	meus
multus	multus
multi	multus
noster	noster
primus	primus
provincia	provincia
pulcher	pulcher#1
qualis	qualis	
quantus	quantus
quorum	quis#1	
Romanus	Romanus
Romani	Romanus
Sardinia	Sardinia
socius	socius
Syria	Syria	
tuus	tuus
vester	vester
vir	vir
@Lesson 5
Anglia	
antea	antea
Apulia	Appulia
carrus	carrus
castra	castrum
copiae	copia#1
Gallia	Gallia	
gladius	gladius
hasta	hasta
Hispania	Hispania
Quintus Horatius Flaccus	Horatius	
laboro	laboro
nuper	nuper
poeta	poeta
postea	postea
propero	propero	
pugno	pugno	
quando	quando
quomodo	quomodo
Sabinus	Sabinus
saepe	saepe
saxum	saxum
sed	sed
villa	villa	
Virginia	
@Lesson 6
agricultura	agricultura
Arethusa	Arethusa
arma	arma	
Ascraeus	Ascraeus
Asia	Asia#1	
Caesar	Caesar
cano	cano	
carmen	carmen#1
Catullus	Catullus
consul	consul
Corinna	Corinna
Cynthia	Cynthia	
de	de#2
Delia	
forma	forma	
Galli	Galli#1	
gaudium	gaudium
gigno	gigno
haec	hic
hostes	hostis
Lesbia	Lesbia	
littera	littera
Mantua	Mantua
muto	muto#2	
Narcissus	Narcissus#2
nunc	nunc
Ovidius	Ovidius
Parthenope	Parthenope
Pompeius	Pompejus
Propertius	Propertius
quem	quis#1	
Sulmo	Sulmo
tantum	tantus
teneo	teneo
Tibullus	Tibullus
Tomis	Tomis	
Vergilius	Vergilius
Verona	Verona
vinco	vinco
@Lesson 7
amicitia	amicitia
appello	appello#2
Daphne	Daphne	
desidero	desidero
deus	deus
Graecus	Graecus
laurus	laurus
narcissus	narcissus#1
olim	olim
supero	supero	
urbs	urbs
vero	verus
@Lesson 8
altus	altus#1	
amor	amor
Bacchus	Bacchus#1
bellum	bellum	
caelum	caelum#2
Ceres	Ceres	
colo	colo#1	
cuius	quis#1	
Iuppiter	Iuppiter
locus	locus
Mars	Mars
munio	munio
nuntius	nuntius
populus	populus#1
Venus	Venus#1	
vinum	vinum	
@Lesson 9
aedificio	aedificium
ago
annus	annus
arbor	arbor#1
aro	aro
Baucis	Baucis
beneficium	beneficium
cado	cado	
colloco	colloco
concors	
cuniunx	
cum	cum
currus	currus
Daedalus	Daedalus#2	
ex	ex
Icarus	Icarus
Io	Ios
ira	ira
Iuno	Juno
levo	levo#1	
ob	ob
penna	penna
pervenio	pervenio
Phaethon	Phaethon
Philemon	
Pheobus	
sine	sine	
sol	sol
volo	volo#2
@Lesson 10
Augustus	Augustus
bis	bis
Brutus	Brutus#2
Caesare	Caesar
Carthago	Carthago#1
Claudius	Claudius
condo	condo	
consules	consul	
creo	creo
Dacia	Dacia	
deleo	deleo
describo	describo
dictator	dictator
divus	divus
duo	duo
expello	expello
fabula	fabula#1
gero	gero#1	
hae	hic
hoc	hic	
inscribo	inscribo
Livius	Livius
nuntio	nuntio
occido	occido#1
Octavianus	Octavianus
Poeni	Poeni	
princeps	princeps
quattuor	quattuor
qui	qui#1	
quot	quot
res	res
rex	rex
Romulus	Romulus#1
septem	septem
sex	sex
Sicilia	Sicilia
tandem	tandem
Tarquinius	Tarquinius
Traianus	Trajanus
tres	tres
@Lesson 11
adsum	adsum
ambulo	ambulo
aperio	aperio
claudo	claudo#2
consido	consido
creta	creta#2	
curro	curro
dico	dico#2
facio	facio
fenestra	fenestra	
festino	festino	
huc	huc
iaceo	jaceo
iam	jam
ianua	janua
laetus	laetus#1
lateo	lateo
mihi	ego
per	per
Procris	
procul	procul
reddo	reddo
salve	salveo	
sedeo	sedeo
sella	sella
sto	sto
surgo	surgo
telum	telum
tibi	tu
vale	valeo
@Lesson 12
ad	ad
agrestis	agrestis
Alpes	Alpis
animus	animus
apud	apud
Cannae	Cannae	
Cantabrigia	
capio	capio#1	
charta	charta
Cisalpinus	Cisalpinus
doceo	doceo
fluvius	fluvius
fugio	fugio
Georgia	
Hannibal	Hannibal
infra	infra
inter	inter
iter	iter	
iacio	jacio
lego	lego#2
Londonium	
manus	manus#1
otium	otium
parvus	parvus
prope	prope
Rubico	Rubico
Suetonius	Suetonius
super	super#2	
supra	supra
Tamesis	Tamesis
traduco	traduco
trans	trans
Trasimenus	
unde	unde
@Lesson 13
@Lesson 14
Aeneas	Aeneas	
ante	ante
Athenae	Athenae
autem	autem
bene	bene
causa	causa
Creusa	Creusa
Demophoon	Demophoon
Dido	Dido#2
ego	ego
et	et
etiam	etiam
frango	frango
hic	hic
hinc	hinc
inquam	inquam
ille	ille
ipse	ipse
is	is
iste	iste
lacrima	lacrima	
laus	laus
mors	mors
nos	nos
oculus	oculus
Phyllis	
praebeo	praebeo
quoque	quo
relinquo	relinquo
se	sui
servo	servo	
suus	suus
Troianus	Trojanus
tu	tu
umbra	umbra	
uxor	uxor
vivo	vivo	
vos	tu 
@Lesson 15
aevum	aevum
alius	alius#2
ara	ara	
ceteri	ceterus
consilium	consilium
fatum	fatum
felix	felix#1	
ferrum	ferrum
fortunatus	fortuno
Hercules	Hercules
iubeo	jubeo
mare	mare	
maximus	magnus#1
miser	miser
narro	narro
nosco	nosco
ora	ora#1
pars	pars
pauci	paucus
qui	qui#1
quicumque	quicumque
quisquis	quisquis
regina	regina
studium	studium
Tacitus	Tacitus#2
Tiberius	Tiberius
trado	trado
Troia	Troja
vitium	vitium
@Lesson 16
aeger	aeger
aliquis	aliquis
ater	ater#1
Catilina	Catilina
Cerinthus	cerinthus
corpus	corpus
cura	cura
dux	dux
eques	eques
homo	homo
labor	labor#2
lex	lex
litus	litus#3
lumen	lumen
lux	lux
Maecenas	Maecenas
malus	malus#1	
mater	mater
miles	miles
mos	mos
nam	nam
Nemesis	Nemesis#2
nomen	nomen
novus	novus
omnis	omnis
oratio	oratio
post	post
principium	principium
rus	rus
saevus	saevus
sidus	sidus
sub	sub
tempus	tempus
ventus	ventus
veritas	veritas
vita	vita
vox	vox
@Lesson 17
aequus	aequus
aestas	aestas
at	at
civis	civis
debeo	debeo
domus	domus
finis	finis
flos	
frater	frater
gens	gens
genus	genu
gloria	gloria	
igitur	igitur
ignis	ignis
imperium	imperium
longus	longus
mens	mens
moenia	moenia#1
mons	mons
moveo	moveo
natura	natura
navis	navis
nihil	nihil
odium	odium#1	
pater	pater
peto	peto
pro	pro#1	
rideo	rideo
sepulcrum	sepulcrum
summus	superus
terreo	terreo	
unus	unus
valles	valles	
ver	
@Lesson 18
adulescens	adulescens
alo	alo	
Antonius	Antonius
apis	apis#1	
beatus	beatus	
brevis	brevis
caelestis	caelestis
campus	campus#2
cogo	cogo
cuncti	cunctus
defendo	defendo
dies	dies
dignus	dignus
discedo	discedo
exiguus	exiguus
fero	fero
fortis	fortis
fortuna	fortuna	
iuvo	juvo
lingua	lingua
longe	longus
medius	medius
mirus	mirus
odi
praeter	praeter
pulvis	pulvis
!res publica	reor	res
similis	similis
soror	soror
species	species	
spiritus	spiritus
tango	tango
tantus	tantus
terra	terra
timeo	timeo
tristis	tristis
videor	video
@Lesson 19
aes	
avis	avis
decem	decem
dulcis	dulcis
durus	durus
fessus	fessus
flamma	flamma#1
fons	fons
gratia	gratia
hora	hora#1
interim	interim
invenio	invenio
iterum	iterum
iuvenis	juvenis
latus	latus#1	
levis	levis#1	
maior	magnus
melior	bonus
nefas	nefas
nobilis	nobilis
peior	malus
pessimus	malus
philosophus	philosophus
plus	multus
probo	probo	
propior	propio
quam	quam	
ripa	ripa
salus	salus
sapiens	sapio
sapientia	sapientia
sentio	sentio
spes	spes
supremus	superus
turpis	turpis
unda	unda
@Lesson 20
amicus	amicus#1
audax	audax
Canada	
color	color
conficio	conficio
credo	credo
dignitas	dignitas
equidem	equidem
exercitus	exercitus#3
facies	facies	
fides	fides#1	
finitimus	finitimus
humanitas	humanitas
idoneus	idoneus
imperator	imperator
incolo	incolo#1
ingenium	ingenium
innocentia	innocentia
magis	magis#3
maxime	magnus#1
mollis	mollis
orbis	orbis	
par	par
plenus	plenus
primum	primus
prius	prior
proximus	proximus
religio	religio
respondeo	respondeo
Rhenus	Rhenus
sanus	sanus
singularis	singularis
varius	varius#1	
victor	victor#1
virtus	virtus
vivus	vivus
@Lesson 21
amans	amo
Britannus	Britannus
careo	careo	
certe	certus
cognosco	cognosco
cupidus	cupidus
cupio	cupio
difficilis	difficilis
disco	disco	
Hadrianus	Hadrianus
idem	idem
iustitia	justitia	
iuvat	juvo
licet	licet
malo	malo	
Martialis	Martialis
memini	memini	
mulier	mulier
neco	neco
nisi	nisi
nolo	nolo
officium	officium
oportet	oportet
patior	patior
placet	placeo	
Plato	Plato
possum	possum
prope	prope
quare	quare
sapio	sapio
scelus	scelus
scio	scio
serus	serus
stultus	stultus
subito	subeo
taberna	taberna
valeo	valeo
verbero	verbero#1
verus	verus
volo	volo#1
@Lesson 22
absum	absum
antequam	antequam
appropinquo	appropinquo
ars	ars
colloquium	colloquium
commoveo	commoveo
confero	confero
contendo	contendo
cultus	cultus#2
cur	cur
donec	donec
dum	dum
eo	eo#1
ferus	ferus
fidelis	fidelis
gratus	gratus
infelix	infelix
ingenuus	ingenuus
iudex	judex
Leander	
legatus	lego	
no	no#1
obses	
paupertas	paupertas
pax	pax
posco	posco
postquam	postquam
proelium	proelium
propterea	propterea
quamquam	quamquam	
quod	qui#1	
reliquus	reliquus
turris	turris
ubi	ubi
ut	ut
@Lesson 23
adversus	adversus#2
albus	albus
celer	celer#1	
cupiditas	cupiditas
deduco	deduco
domina	domina
educo	educo#1	
extremus	extremus
facilis	facilis
fas	fas
folium	folium
fuga	fuga	
hiberna	hibernus
inopia	inopia
invitus	invitus
iuxta	juxta
laedo	laedo
loquor	loquor
metus	metus
Minerva	Minerva
modo	modo	
nusquam	nusquam
opus	opus#1
os	os#1
pilum	pilum	
possideo	possideo
prohibeo	prohibeo
puto	puto	
quidem	quidem
recipio	recipio
rectus	rego
regnum	regnum
rogo	rogo	
salvus	salvus
scutum	scutum
superior	superus
vel	vel
vigilia	vigilia
voco	voco
@Lesson 24
accipio	accipio
Apollo	Apollo
armo	armo	
auctoritas	auctoritas
comes	come#1	
conduco	conduco
confirmo	confirmo
consuetudo	consuetudo
depello	depello
eo	eo#1
fere	fere
illuc	illic
initium	initium
Italicus	Italicus
iuro	juro
lyricus	lyricus
modus	modus
morbus	morbus
nego	nego
nemo	nemo
nihilum	nihilum
numerus	numerus
opinio	opinio
plurimus	multus	
polliceor	polliceor
promitto	promitto
quisquam	quisquam
quoniam	quoniam
redeo	redeo
senex	senex
senior	senex	
spero	spero
statim	statim
videtur	video
@Lesson 25
canto	canto
carpo	carpo
cedo	cedo#1
clarus	clarus
coram	coram
desino	desino
desum	desum
edo	edo#2	
enim	enim
epistula	epistula
expedit	expedio
festus	festus#1
flumen	flumen
gaudeo	gaudeo
humus	humus
ignotus	ignotus#2
Iuvenalis	Juvenalis#2	
libenter	libet
Musae	Musa#1	
nonus	nonus
novissimus	novus
opto	opto
os	os#2
pectus	pectus
pereo	pereo
pes	pes
placeo	placeo
premo	premo
proficio	proficio
prudens	prudens
Quintilianus	Quintilianus#1
quis	quis#1	
ratio	ratio
senectus	senectus#2
severus	severus#1
sic	sic
tum	tum
utinam	utinam
valde	validus
voluntas	voluntas
@Lesson 26
adventus	adventus
almus	almus
amabilis	amabilis
avunculus	avunculus
certus	certus
civitas	civitas
committo	committo
conor	conor
exeo	exeo
fio	fio
hortor	hortor
immortalis	immortalis
impetro	impetro
intra	intra	
ne	ne#1	
neve	neve
nox	nox
obtineo	obtineo
occupo	occupo
oppugno	oppugno#1
orior	orior
periculum	periculum
persuadeo	persuadeo
pons	
possim	possum
posterus	posterus
principatus	principatus	
proficiscor	proficiscor
quidam	quidam
quo	quo
quondam	quondam
rapio	rapio
removeo	removeo
solus	solus#1
tempestas	tempestas
theatrum	theatrum
ullus	ullus
ut	ut
@Lesson 27
abeo	abeo
accido	accido#2
aeternus	aeternus
anima	anima	
augeo	augeo
celeritas	celeritas
commode	commodus#1
constitutus	constituo
curo	curo
efficio	efficio
effugio	effugio	
exemplum	exemplum
fac	facio
formosus	formosus
honos	honor
incredibilis	incredibilis
inops	inops
irascor	irascor
Lucretius	Lucretius
maturus	maturus
necesse	necesse
nisi	nisi
paene	paene
placabilis	placabilis
placo	placo
possem	possum
potuissem	possum
prodo	prodo
recordor	recordor
saeculum	saeculum
Socrates	Socrates
tam	tam
tamen	tamen
tenebrae	tenebrae
terror	terror
tot	tot
vigeo	vigeo
@Lesson 28
an	an
arbitror	arbitror
aut	aut
avus	avus
candidus	candidus
centum	centum
consulo	consulo
crucio	crucio
fluo	fluo
forsitan	forsitan
fortasse	fortasse
ignoro	ignoro
interea	interea
iudico	judico
iustus	justus
Lupercal	Lupercal
mercator	mercator
motus	motus#2	
nascor	nascor
natio	natio
-ne	
nec	neque
necne	necne
nescio	nescio	
nix	nix
nonne	nonne	
notus	nosco	
num	num
ostendo	ostendo
precor	precor
quaero	quaero
quam	quam
qoutus	
requiro	requiro
reservo	reservo
signum	signum
sive	sive
sors	sors
ter	ter
undique	undique
uter	uter#3
utrum	utrum
@Lesson 29
acer	acer#2
adversus	adversus
alter	alter	
auctor	auctor
crimen	crimen
deinde	deinde
divido	divido	
doctus	doceo
explorator	explorator
inferus	inferus
inutilis	inutilis
libellus	libellus
metuo	metuo
mille	mille
nullus	nullus
opes	ops#1
pagus	pagus
parens	parens#2
passus	passus#3
plebs	plebs
propono	propono
quindecim	
quinque	quin
recens	recens
satura	satura	
secundus	secundus#1
septimus	septimus
tempto	tento
tertius	tertius
totus	totus#1	
turba	turba	
uterque	uter#3
viginti	viginti
@Lesson 30
adeo	adeo#1	
aio	aio
aliquis	aliquis
ante	ante
atomus	atomus
auris	auris
censeo	censeo#1
Cinara	Cinara#2
contingo	contingo#1
Corinthus	Corinthus
decet	decet
Democritus	Democritus
eligo	eligo
Epicurus	Epicurus
Epicureus	Epicureus
evenio	evenio
exstinguo	exstinguo
felicitas	felicitas#1	
humanus	humanus
manes	manes	
morior	morior	
mortuus	morior	
neglego	neglego
nescio	nescio	
occido	occido#2
omitto	omitto
qualis	qualis
queror	queror
quisque	quisque
quivis	quivis
quot	quot
rarus	rarus
rotundus	rotundus
Stoicus	Stoicus
talis	talis	
umquam	umquam
una	unus
usquam	usquam
utilis	utilis
@Lesson 31
admiror	admiror
arduus	arduus
arx	arx
aureus	aureus
aurum	aurum
blandus	blandus
breviter	brevis	
commeatus	commeatus
culpa	culpa	
cupido	cupido	
demens	demens	
desisto	desisto
deligens	deligo#1
dulcedo	dulcedo
ergo	ergo
excedo	excedo
fallo	fallo
ferreus	ferreus
haud	haud
mitis	mitis
nitidus	nitidus
perfero	perfero	
pomum	pomum	
praetereo	praetereo
profero	profero
prudentia	prudentia
quia	quia
refero	refero
salutem	salus	
satis	satis
strepo	
taceo	taceo
valetudo	valetudo
velox	velox
virgo	virgo
@Lesson 32
addo	addo
aetas	aetas
aptus	aptus
Aristoteles	Aristoteles
audeo	audeo
Christianus	Christianus
Christus	Christus
constans	consto
constantia	constantia#1
contra	contra
convenio	convenio
decorus	decorus
divinus	divinus
divitiae	divitiae
egeo	egeo
error	error
hospes	hospes
iaculum	jaculum	
lux	lux
mediocritas	mediocritas
mereor	mereor
miror	miror
mortalis	mortalis
munus	munus
patientia	patientia
Plinius	Plinius
priscus	priscus#1
pudor	pudor
purus	purus
quasi	quasi
revertor	revorto
ridiculus	ridiculus
senator	senator
sequor	sequor
soleo	soleo
tandem	tandem
tollo	tollo
tutus	tueor
utor	utor
venustus	venustus
@Lesson 33
caput	caput
coepi	coepio
decedo	decedo
deficio	deficio
doleo	doleo
dono	dono	
egredior	egredior
forte	fors	
impedimentum	impedimentum
ludus	ludus
maturo	maturo	
multitudo	multitudo
nasus	nasus#1
olfacio	
pareo	pareo
pateo	pateo
pauper	pauper
perdo	perdo
perfacilis	perfacilis
pinguis	pinguis
plerique	plerus
porta	porta	
potior	potior	
praesto	praesto#2
respicio	respicio
sagitta	sagitta	
tribuo	tribuo
vallum	vallum	
vates	vates
velut	velut
vulnus	vulnus
@Lesson 34
abhinc	abhinc
adfero	affero
cena	cena	
ceno	ceno
commodum	commodus#1
consensus	consensus#2	
constituo	constituo
consularis	consularis	
contemno	contemno
dea	dea
desero	desero#2
expono	expono
faveo	faveo
gravis	gravis
ibi	ibi
immaturus	immaturus	
impero	impero
inanis	inanis
incido	incido#1
loco	loco	
ludo	ludo	
minus	parvus
molestus	molestus
multo	multus
nimium	nimius
numen	numen
omnino	omnino
pius	pius
poena	poena
privatus	privo
quiesco	quiesco
sal	
sin	sin
versus	versus#3	
vis	vis
@Lesson 35
adduco	adduco
adprobo	approbus
adulescens	adulescens
agmen	agmen
angustus	angustus
collis	collis	
consisto	consisto
conspicio	conspicio#1
convalesco	convalesco
descendo	descendo
difficultas	difficultas
dolor	dolor
fera	fera	
fore	sum#1
legio	legio
Lucanus	Lucanus
medeor	medeor
mora	mora#1	
noceo	noceo
nubo	
obsto	obsto
parco	parco	
paro	paro#1	
portus	portus
potius	potis
praeficio	praeficio
praesidium	praesidium
praesum	praesum
quam	quam	
sero	serus
servio	servio
studeo	studeo
subsidium	subsidium
superbus	superbus
usus	usus#2	
@Lesson 36
accedo	accedo
acies	acies
adulescentia	adulescentia
caedes	caedes	
decerno	decerno
dextra	dexter	
doctrina	doctrina
dummodo	
existimo	existimo
fateor	fateor
foris	foris#2	
habitus	habitus#3
impedio	impedio
incendium	incendium
iners	iners
itaque	ita	
lacus	lacus
libero	libero
obvius	obvius
opis	ops#1
orno	orno	
pecco	pecco
praeclarus	praeclarus
priusquam	prior
propius	propius
quamvis	quamvis
segnis	segnis
spatium	spatium
sumo	sumo
Terentius	Terentius	
tergum	tergum
verto	verto
verum	verus
@Lesson 37
antiquus	antiquus
caedo	caedo
circumvenio	circumvenio
communis	communis
concedo	concedo
concordia	concordia#1
contineo	contineo
diligo	diligo
expleo	expleo
impetus	impetus
inimicus	inimicus
intellego	intellego
iudicium	judicium
liberalis	liberalis#1
libertas	libertas
magistratus	magistratus	
magnitudo	magnitudo
malefactum	malefacio
opinor	opinor
pertineo	pertineo
Plautus	Plautus#2
quippe	quippe
saluto	saluto
sententia	sententia
sitis	sitis	
solitudo	solitudo
tamquam	tamquam
timidus	timidus
tueor	tueor
vereor	vereor
vinculum	
@Lesson 38
carus	carus#1
cunctor	cunctor
decido	decido#1
digitus	digitus#1
dimitto	dimitto
domo	domo	
facultas	facultas
iniuria	injuria	
iungo	jungo
misceo	misceo
nanciscor	nanciscor
necessarius	necessarius
oro	oro
pertimesco	pertimesco
praefero	praefero
procedo	procedo
propter	propter
pulso	pulso
punio	punior
quilibet	
regno	regno	
retineo	retineo
sanctus	sancio	
semel	semel
sepelio	sepelio
solvo	solvo
tempero	tempero
venia	venia
vestis	vestis
@Lesson 39
accuso	accuso
adipiscor	
auxilium	auxilium
demonstro	demonstro
!fore ut	foris#1	forum	forum#1	forus	forus#1	sum#1
gratulor	gratulor
invisus	invideo	
ius	jus
natalis	natalis#2
nocturnus	nocturnus
perficio	perficio
pugna	pugna	
senatus	senatus
spolio	spolio	
supersum	supersum
timor	timor
transeo	transeo
venor	venor
victoria	victoria
voluptas	voluptas
vultus	vultus
@Lesson 40
aestimo	aestimo
condemno	condemno
conloquor	con-loquor
damnum	damnum
desiderium	desiderium
exsilium	exsilium
fraus	fraus
fruor	fruor
Homerus	Homerus
ignominia	ignominia
imago	imago
immemor	immemor
innocens	innocens
interest	intersum
libido	libido
memor	memor#1
obliviscor	obliviscor
paenitet	paeniteo
paulo	paulus#1
piget	pigeo
potentia	potentia#1
pudet	pudeo
responsum	respondeo
sino	sino
solum	solum#1	
suavis	suavis
taedet	taedet
tendo	tendo
ulterior	
uro	uro
@Lesson 41
barbarus	barbarus
consentio	consentio	
continentia	continentia#1
despicio	despicio
deterreo	deterreo
dubito	dubito
dubium	dubius
fieri	fio
furor	furor#2
hiems	hiems
honestas	honestas
incoho	incoho
incommodum	incommodum
magnopere	magnopere
memoria	memoria
modo	modus
pristinus	pristinus#1	
quin	quin
quominus	
reminiscor	reminisco
solum	solus#1
summa	summa	
ultimus	ulter
utilitas	utilitas
veto	veto
vetus	vetus
vulnero	vulnero
