#Latin: A Structural Approach Sweet, Waldo (1957)
@
@cura
lupus	lupus#1
vir	vir
vestis	vestis
fur	fur
nemo	nemo
amor	amor
veritas	veritas
manus	manus#1
res	res
spes	spes
pulchra	pulcher#1
sapiens	sapio
honestus	honestus
fortis	fortis
fidelis	fidelis
@Lesson 2
agnus	agnus
oculus	oculus
femina	femina	
amphora	amphora
vestitus	vestitus#3
felix	felix#1	
amicus	amicus#1
prudens	prudens
stultus	stultus
facit	facio
congnoscit	con-nosco
vivit	vivo
quaerit	quaero
videt	video
lavat	lavo
solvit	solvo
perit	pereo
et	et
in	in
non	non
cum	cum
sine	sine	
numquam	numquam
@Lesson 3
vita	vita
fortuna	fortuna	
sapientia	sapientia	
barba	barba#1
constantia	constantia#1	
concordia	concordia#1
industria	industria#2
philosophus	philosophus
vulpes	vulpis
fraus	fraus
laus	laus
lis	lis
virtus	virtus
occasio	occasio
fortitudo	fortitudo
integritas	integritas
fides	fides#1	
vult	volo#1
generat	genero
regit	rego
mordet	mordeo
-que	
@Lesson 4
amphora	amphora
opera	opera	
canis	canis#1	
aper	aper#1
labor	labor#2
honor	honor
antiqua	antiquus
magnus	magnus#1
aeger	aeger
pauper	pauper
tenet	teneo
portat	porto
vincit	vincio	
gignit	gigno
vestis	vestis
offert	offertor
amittit	amitto
sape	sapio
sub	sub
ab	ab
@Lesson 5
aqua	aqua
ira	ira
avaritia	avaritia
poena	poena
deus	deus
filius	filius
fons	fons
lex	lex
imitatio	imitatio
necessitas	necessitas
lux	lux
pater	pater
pura	purus
mea	meus
purus	purus
nullus	nullus
citus	cieo
iratus	irascor
malus	malus#1	
bonus	bonus
omnis	omnis
defluit	defluo
est	sum#1
habet	habeo
de	de#2
ex	ex
@Lesson 6
malum	malum	
bonum	bonum	
vitium	vitium
vinum	vinum	
consilium	consilium
periculum	periculum
auxilium	auxilium
corpus	corpus
mare	mare	
opus	opus#1
harena	harena
forma	forma	
puer	puer
mens	mens
gladiator	gladiator
aetas	aetas
finis	finis
sana	sanus
sanum	sanus
alienum	alienus
suum	suus
petit	peto
emendat	emendo
fugit	fugio
coronat	corono
corrumpit	corrumpo
capit	capio#1
sed	sed
semper	semper
@Review Lesson 1
capillus	capillus
oratio	oratio
felicitas	felicitas#1	
dolor	dolor
natura	natura
umbra	umbra	
ordo	ordo
exitus	exitus#2
panis	panis	
venenum	venenum
auris	auris	
dies	dies
homo	homo
unus	unus
blandus	blandus
dubius	dubius
solus	solus#1
vilis	vilis
obumbrat	obumbro
nobilitat	nobilito
minuit	minuo
tractat	tracto
etiam	etiam
@Lesson 7
bestia	bestia#1
verbum	verbum
scorpio	scorpius
actum	ago
gaudium	gaudium
exemplum	exemplum
Venus	Venus#1	
lacrima	lacrima	
religio	religio
natus	nascor
lapis	lapis
superstitio	superstitio
quaeque	quisque
parvis	parvus
crudelis	crudelis
pauci	paucus
fallit	fallo
certat	certo#2
colit	colo#1
curat	curo
movet	moveo
dormit	dormio
pascit	pascor
violat	violo
neglegit	neglego
trahit	traho
frangit	frango
@Lesson 8
crimen	crimen
necessitudo	necessitudo
tempus	tempus
piscis	piscis
ars	ars
munus	munus
timidus	timidus
timet	timeo
adjuvat	adjuvo
numerat	numero#1
cernit	cerno
fert	fero
@Review Lesson 2
animus	animus
orbis	orbis	
fatum	fatum	
caelum	caelum#2
Iuppiter	Iuppiter
terra	terra
Caesar	Caesar
levis	levis#1	
alius	alius#2
dicit	dico#2
ornat	orno
creat	creo
ditat	dito
stat	sto
cogitat	cogito
@Lesson 9
mulier	mulier
flos	
nobilitas	nobilitas
littera	littera
studium	studium
victoria	victoria
dux	dux
ver	
aspicit	aspicio
dat	do#1	
docet	doceo
reddit	reddo
discit	disco
caret	careo
superus	superus
longus	longus
iustus	justus
ibi	ibi
sic	sic
@Lesson 10
navis	navis	
flumen	flumen
thesaurus	thesaurus
inops	inops
innocens	innocens
eloquens	eloquor
parvulus	parvulus
cautus	caveo
patrius	patrius#1	
captivus	captivus
vivus	vivus
strenuus	strenuus
cupit	cupio
amat	amo
invenit	invenio
qui	qui#1	
quicumque	quicumque
pro	pro#1	
satis	satis
quia	quia
ac	atque
@Lesson 11
ad	ad
ante	ante
contra	contra
extra	extra	
in	in
inter	inter
intra	intra	
per	per
post	post
praeter	praeter
prope	prope
propter	propter
sub	sub
super	super#2	
supra	supra
trans	trans
gloria	gloria	
iter	iter	ito
tenebrae	tenebrae
cor	cor	cur
praeceptum	praecipio
ecclesia	ecclesia
hospes	hospes
via	via	
salus	salus
vertit	verto
currit	curro
cogit	cogo
vilescit	
mutat	muto#1
efficax	efficax
luscus	luscus
mollis	mollis
caecus	caecus#1
intus	intus
@Lesson 12
vox	vox
lignum	lignum
unda	unda	
vultus	vultus
ignis	ignis
hora	hora#1
ops	ops#1
tacet	taceo
ruit	ruo
olet	oleo#1
latrat	latro#1
celat	celo
redit	redeo
manet	maneo	
alter	alter	
grandis	grandis
rectus	rego
perpetuus	perpetuus
statim	statim
@Lesson 13
insidiae	insidiae
furor	furor#2
fletus	fletus#3
amicitia	amicitia
audit	audio
indicat	indico#1	
laedit	laedo
ponit	pono
perficit	perficio
litigat	litigo
parat	paro#1	
jucundus	jucundus
ebrius	ebrius
simul	simul
aut	aut
@Lesson 14
leo	leo#2	
ventus	ventus
fames	fames
coquus	coquus
amnis	amnis
ebrietas	ebrietas
donum	donum
insania	insania
concrescit	concresco
perdit	perdo
spernit	sperno
mortuus	morior
mobilis	mobilis
intolerabilis	intolerabilis
modicus	modicus
voluntarius	voluntarius
@Lesson 15
unus	unus
duo	duo
tres	tres
quattuor	quattuor
quinque	quin
sex	sex
septem	septem
octo	octo
novem	novo
decem	decem
undecim	undecim
duodecim	
tredecim	
quattuordecim	
primus	primus
secundus	secundus#1
tertius	tertius
quartus	quartus
quintus	quintus#1
sextus	sextus#1
septimus	septimus
octavus	octavus
nonus	nonus
decimus	decimus#1
undecimus	undecimus
duodecimus	duodecimus
!tertius decimus	tertius
!quartus decimus	quartus
singuli	singulus
bini	bini
terni	terni
quaterni	quaterni
quini	quini
seni	seni	
septeni	septeni
octoni	octoni
noveni	novenus
deni	deni
quindecim	
sedecim	
septendecim	
duodeviginti	
undeviginti	
viginti	viginti
triginta	triginta
quadraginta	quadraginta
quinquaginta	quinquaginta
sexaginta	sexa_ginta
septuaginta	septuaginta
octoginta	octoginta
nonaginta	nonaginta
centum	centum
ducenti	ducenti	
trecenti	trecenti
quadrigenti	
quingenti	quingenti
mille	mille
duodevicesimus	duodevicesimus
undevicesimus	undevicesimus
vicesimus	vicesimus
mundus	mundus#1
venit	venio
fidus	fidus#1
vehemens	vehemens
princeps	princeps
par	par
gratus	gratus
plenus	plenus
prope	prope
@Lesson 16
beneficium	beneficium
frater	frater
servit	servo
placet	placeo
favet	faveo
flet	fleo
eget	egeo
celer	celer#4
liber	liber#1	
insipiens	insipiens
bis	bis
@Lesson 17
gratia	gratia
Musa	Musa#1	
senectus	senectus#2
urbs	urbs
solitudo	solitudo
resistit	resisto
imponit	impono
nocet	noceo
lucet	luceo
nubit	nubo
instat	insto
superbus	superbus
ingratus	ingratus
amplus	amplus
humilis	humilis
miser	miser
autem	autem
nisi	nisi	
@Lesson 18
firmamentum	firmamentum
medicamen	medicamen
imago	imago
timor	timor
vis	vis	
index	index
odor	odor
calamitas	calamitas	
Roma	Roma
pingit	pingo
contra	contra
@Lesson 19
iustitia	justitia
regina	regina
opinio	opinio
templum	templum
crux	crux
iudicat	judico
volvit	volvo
praeterit	praetereo
tutus	tueor
securus	securus
@Lesson 20
marinus	marinus
tamquam	tamquam
@Lesson 21
orator	orator
sequitur	sequor
nascitur	nascor
miratur	miro	miror
loquitur	loquor
moritur	morior
veretur	vereor	
imitatur	imitor
mentitur	mentior
irascitur	irascor
totiens	totiens
persaepe	persaepe
extra	extra	
post	post
@Lesson 22
potest	possum	
solet	soleo	
monet	moneo
queritur	queror
tollit	tollo
Romanus	Romanus
proprius	proprius
decorus	decorus
tuus	tuus
vel	vel
@Lesson 23
pallium	pallium
Mamona	
securitas	securitas
malo	malo	
serenus	serenus#1
nondum	nondum
ergo	ergo
@Lesson 24
certamen	certamen
sceptrum	sceptrum
cursus	cursus
tyrannus	tyrannus
ager	ager
eripio	eripio
cado	cado	
audeo	audeo
coepi	coepio
aedifico	aedifico
consummo	consummo
odi	odi	
ludo	ludo	
edo	edo#1	
abeo	abeo
servo	servo	
divinus	divinus
@Lesson 25
sidus	sidus
equus	equus#1
lumen	lumen
fulgeo	fulgeo
tristis	tristis
nocturnus	nocturnus
@Lesson 26
ferrum	ferrum
actio	actio
arcus	arcus
stringo	stringo
ignosco	ignosco
rumpo	rumpo	
tendo	tendo
laxo	laxo	
dono	dono	
suadeo	suadeo
@Lesson 27
origo	origo#1
iudicium	judicium
angulus	angulus
probo	probo	
flecto	flecto
progredior	progredior
finio	finio
deterior	deterior
@Lesson 28
daemon	daemon
suscito	suscito
ejicio	
contendo	contendo
utor	utor
infirmus	infirmus
carus	carus#1
verbosus	verbosus
nimis	nimis
@Lesson 29
respicio	respicio
desidero	desidero
praeparo	praeparo
culpo	culpo
concordo	concordo
rapio	rapio
aequus	aequus
@Lesson 30
Democritus	Democritus
circus	circus
hircus	hircus
rideo	rideo
libet	libet	
barbarus	barbarus
rusticus	rusticus
barbatus	barbatus
en	en
dummodo	
@Lesson 31
Hector	Hector
arbitrium	arbitrium
nosco	nosco
temere	temere
antequam	antequam
inde	inde	
@Lesson 32
mutatio	mutatio
radix	radix
Cato	Cato	
tego	tego
decet	decet
prosum	prosum
arbitror	arbitror
verecundus	verecundus
aliqui	aliqui	
@Lesson 33
as	
merces	merces#1
incipio	incipio
memini	memini	
diluceo	diluceo
foveo	foveo
ajo	aio
piget	pigeo
turpis	turpis
forsan	forsan
olim	olim
@Lesson 34
gutta	gutta#1
vigilo	vigilo
consulo	consulo
cavo	cavo	
delibero	delibero
restituo	restituo
tardo	tardo	
cunctor	cunctor
nego	nego
prosperus	prosperus
@Lesson 35
vulnus	vulnus
puto	puto	
apparo	appario
cano	cano	
repudio	repudio	
consto	consto
tueor	tueor
diu	diu
heu	heu
