#Traditio, Patricia A. Johnston, 2nd Edition, 1998
@Chapter 1
amo	amo
canto	canto
capto	capto	
cogito	cogito	
erro	erro#1	
opto	opto
paro	paro#1	
spero	spero
spiro	spiro
moneo	moneo
mordeo	mordeo
teneo	teneo
timeo	timeo
video	video
do	do#1
noli	nolo
cur	cur
non	non
saepe	saepe	
@Chapter 2
agricola	agricola#1
amica	amicus#2
bestia	bestia#1
filia	filia
invidia	invidia
nauta	nauta
poeta	poeta	
puella	puella
stella	stella
via	via	
ager	ager
amicus	amicus#2
auxilium	auxilium
caelum	caelum#2
dominus	dominus
donum	donum
filius	filius
liber	liber#4	
magister	magister
numerus	numerus
servus	servus#2
puer	puer
verbum	verbum
vinculum	vinculum
vir	vir
amatus	amo
bonus	bonus
clarus	clarus
datus	do#1	
liber	liber#2	
magnus	magnus#1
malus	malus#1	
meus	meus
miser	miser
noster	noster
parvus	parvus
pulcher	pulcher#1
tuus	tuus
vester	vester
visus	video	
dum	dum
et	et
in	in
me	ego
sed	sed
te	tu
@Chapter 3
ago	ago
appello	appello#1
audio	audio
bibo	bibo#1	
cado	cado	
capio	capio#1	
debeo	debeo
dico	dico#2
duco	duco
facio	facio
fugio	fugio
lego	lego#2
mitto	mitto
nescio	nescio	
peto	peto
possum	possum
pulso	pulso
respondeo	respondeo
scio	scio	
sentio	sentio
sum	sum#1
venio	venio
vivo	vivo	
conviva	conviva
cura	cura	
gratia	gratia
ianua	janua
lingua	lingua
terra	terra
vita	vita	
ego	ego
nos	nos
quid	quis#1	
quis	quis#1	
tu	tu
alius	alius#2
alter	alter	
ebrius	ebrius
Latinus	Latinus	
neuter	neuter
nullus	nullus
salvus	salvus
solus	solus#1
totus	totus#1	
ullus	ullus
unus	unus
uter	uter#3
hic	hic
iam	jam
ibi	ibi
tum	tum
ubi	ubi
quod	qui#1	
si	si
ab	ab
cum	cum
sine	sine	
@Chapter 4
adsum	adsum
ambulo	ambulo
cedo	cedo#1
cognosco	cognosco
demonstro	demonstro
desum	desum
habeo	habeo
iubeo	jubeo
nosco	nosco
pono	pono
quaero	quaero
salveo	salveo
salve	salvus
supersum	supersum
voco	voco
animus	animus
aqua	aqua
causa	causa
cibus	cibus
consilium	consilium
femina	femina	
pecunia	pecunia
satis	satis
ceteri	ceterus
ignotus	ignotus#2
insanus	insanus#1
molestus	molestus
multus	multus
sanus	sanus
satis	satis
bene	bene	
certe	certus
hodie	hodie
numquam	numquam
nunc	nunc
satis	satis
sic	sic
solum	solus#1
umquam	umquam
atque	atque
aut	aut
nam	nam
nisi	nisi	
ut	ut
ne	ne#1	
nec	neque
ad	ad
ante	ante
de	de#2
@Chapter 5
celo	celo
censeo	censeo#1
cogo	cogo
commendo	commendo
credo	credo
curo	curo
delibero	delibero
distraho	distraho
extraho	extraho
iacio	jacio
impendeo	impendeo
laudo	laudo
maneo	maneo
remaneo	remaneo
traho	traho
valeo	valeo
audacia	audacia
equus	equus#1
fortuna	fortuna	
modus	modus
nihil	nihil
nuptiae	nuptiae
remedium	remedium
sententia	sententia
aequus	aequus
incertus	incertus
integer	integer
invitus	invitus
quantus	quantus
quot	quot
saevus	saevus
tantus	tantus
timidus	timidus
tot	tot
ergo	ergo
etiam	etiam
nonne	nonne	
num	num	
simul	simul
enim	enim
ex	ex
@Chapter 6
agito	agito
amitto	amitto
declamo	declamo
disco	disco
disputo	disputo
doceo	doceo
exerceo	exerceo
floreo	floreo	
formo	formo	
imbuo	imbuo
impleo	impleo
instituo	instituo
laboro	laboro
ludo	ludo	
malo	malo	
memini	memini	
muto	muto#2	
nolo	nolo
ostendo	ostendo
propono	propono
rogo	rogo
scribo	scribo
sedeo	sedeo
servo	servo	
solvo	solvo
sono	sono	
volo	volo#1	
canticum	canticum	
deliciae	deliciae
deus	deus
discipula	discipula
discipulus	discipulus
divitiae	divitiae
elementum	elementum
eloquentia	eloquentia
exemplum	exemplum
fabula	fabula#1
fama	fama
infantia	infantia	
liberi	liberi	
littera	littera
ludus	ludus
memoria	memoria
mundus	mundus#2
natura	natura
opprobrium	opprobrium
paedagogus	paedagogus
sapientia	sapientia
schola	schola
sonus	sonus#2
studium	studium
vicinus	vicinus
vitium	vitium
qui	qui#1	
quis	quis#1	
dignus	dignus
fictus	fingo
honestus	honestus
inhonestus	inhonestus
pudicus	pudicus
impudicus	impudicus
purus	purus
deinde	deinde
male	malus#1	
mox	mox
quam	quam	
quando	quando
an	an
quam	quam	
!quam ob rem	quam	qui#1	qui#2
quando	quando
quare	quare
quo	quo
num	num	
unde	unde
antequam	antequam
seu	sive
sive	sive
@Chapter 7
averto	averto
claudo	claudo#1	
concludo	concludo
contemno	contemno
cresco	cresco
decet	decet
excludo	excludo
planto	planto
probo	probo	
proficio	proficio
profundo	profundo	
provenio	provenio
puto	puto	
soleo	soleo
tolero	tolero
verto	verto
benevolentia	benevolentia
decorum	decorus	
gloria	gloria	
grammaticus	grammaticus#1
ingenium	ingenium
letum	letum
negotium	negotium
oculus	oculus
officium	officium
otium	otium
parum	parus#1
patria	patrius#1	
persona	persona	
philosophus	philosophus
planta	planta	
populus	populus#1	
is	is
se	sui
adultus	adolesco
decorus	decorus
indecorus	indecorus
iustus	justus
perversus	perverto
plenus	plenus
poeticus	poeticus
publicus	publicus
severus	severus#1
suus	suus
autem	autem
contra	contra
parum	parum	
pro	pro#1	
@Chapter 8
abeo	abeo
adeo	adeo#1	
ambio	
constituo	constituo
eo	eo#1	
gero	gero#1	
ineo	ineo
insum	insum
pereo	pereo
praetereo	praetereo
prodeo	pro-eo#1
redeo	redeo
removeo	removeo
studeo	studeo
vito	vito
annus	annus
arbor	arbor#1
Athenae	Athenae
auditor	auditor
brevitas	brevitas
consul	consul
corpus	corpus
defensio	defensio
dux	dux
factum	facio	
genus	genu
homo	homo
hora	hora#1
iniuria	injuria	
Italia	Italia
ius	jus
lex	lex
libertas	libertas	
mos	mos
multitudo	multitudo
narratio	narratio
nomen	nome	nomen
opinio	opinio
oratio	oratio
orator	orator
pater	pater
probabilitas	probabilitas
Roma	Roma
rus	rus
tempus	tempus
veritas	veritas
virtus	virtus
vulgus	vulgus
certus	certus
longus	longus
medius	medius
novus	novus
opportunus	opportunus
Romanus	Romanus
item	item	
@Chapter 9
absum	absum
addo	addo
ardeo	ardeo
converto	converto
deduco	deduco
gleo	
fluo	fluo
fundo	fundo#1	
incendo	incendo
libero	libero
monstro	monstro	
opprimo	opprimo
perverto	perverto
praecedo	praecedo
premo	premo
reddo	reddo
reprimo	reprimo
scindo	scindo
sto	sto
subdo	subdo
supero	supero	
trado	trado
amor	amor
bos	bos
cauda	cauda
Cacus	Cacus#1	
Deianira	Deianira
dolor	dolor
flamma	flamma#1	
fluvius	fluvius
frons	frons#2
grex	grex
Hercules	Hercules
ignis	ignis
Iuno	Juno
Iuppiter	Iuppiter
labor	labor#2
membrum	membrum
monstrum	monstrum
nemo	nemo
pars	pars
pulchritudo	pulchritudo
pyra	pyra
sanguis	sanguis
sopor	sopor
spelunca	spelunca
vastigium	
vestis	vestis
vinum	vinum	
vox	vox
hic	hic
idem	idem
ille	ille
ipse	ipse
iste	iste
altus	altus#1	
divinus	divinus
durus	durus
falsus	fallo	
fessus	fessus
herculeus	
humanus	humanus
ignarus	ignarus
nescius	nescius
saucius	saucius
varius	varius#1	
verus	verus
adeo	adeo#2
ita	ita	
olim	olim
prope	prope
sic	sic
tam	tam
postquam	postquam
inter	inter
prae	prae
prope	prope
trans	trans
@Chapter 10
colo	colo#1	
comedo	comedus
contineo	contineo
desino	desino
egeo	egeo
excedo	excedo
expello	expello
fingo	fingo
gigno	gigno
interficio	interficio
loco	loco	
noceo	noceo
pello	pello
perficio	perficio
prosum	prosum
pugno	pugno	
rapio	rapio
rego	rego
relinquo	relinquo
tollo	tollo
vinco	vinco
aer	aer
aetas	aetas
anima	anima	
arma	arma	
beneficium	beneficium
civitas	civitas
cogitatio	cogitatio
figura	figura	
forma	forma	
honor	honor
locus	locus
lux	
miles	miles	
natus	natus#1
opus	opus#1
patrimonium	patrimonium
pax	pax
periculum	periculum
potentia	potentia#1
ratio	ratio
sol	sol
spatium	spatium
aeternus	aeternus
alienus	alienus
antiquus	antiquus
cunctus	cunctus
impius	impius
rectus	rego
superbus	superbus
vivus	vivus
idcirco	idcirco
libenter	libet
quidem	quidem
quoque	quo
sicut	sicut
quia	quia
vel	vel
igitur	igitur
per	per
apud	apud
@Chapter 11
augeo	augeo
cano	cano	
iacto	jacto
intellego	intellego
memoro	memoro
mereo	mereo	
nuntio	nuntio	
paco	
praesum	praesum
recipio	recipio
subicio	subicio
sumo	sumo
turbo	turbo#1	
aedes	aedes
animal	animal
ara	ara	
ars	ars
bellum	bellum	
caput	caput
civis	civis
cor	cur
dens	dens
exemplar	exemplar
finis	finis
forum	forum#1	
gens	gens
imago	imago
imperium	imperium
intellegentia	intellegentia	
ira	ira
laus	laus
mare	mare	
mens	mens
mensis	mensis	
mors	mors
natio	natio
nox	nox
nubes	nubes	
orbis	orbis	
pes	pes
princeps	princeps
principium	principium
provincia	provincia
rex	rex
scriptor	scriptor
senex	senex
silentium	silentium
superi	superus
urbs	urbs
victoria	victoria
vis	vis	
nescioquis	nescioquis
acer	acer#2
adversus	adversus
augustus	augustus#1
brevis	breve	brevis
celer	celer4
civilis	civilis#2
communis	communis
divus	divus
dulcis	dulcis
elegens	ex-lego#2
felix	felix#1	
fortis	fortis
iudicialis	judicialis
memor	memor#1
mortalis	mortalis
obscurus	obscurus
omnis	omnis
potens	possum	
prosperus	prosperus
qualis	qualis	
sapiens	sapio
superus	superus
circum	circum	
cito	cieo	
diu	diu
inde	inde	
procul	procul
scilicet	scilicet
circum	circum	
ob	ob
post	post
sub	sub
@Chapter 12
affero	affero
appareo	appareo
aufero	aufero
confero	confero
cupio	cupio
curro	curro
defero	defero
differo	differo
discedo	discedo
effero	effero#1	
fero	fero	
imprimo	imprimo
infero	infero	
offero	offertor
oppono	oppono
pando	pando#2	
procedo	procedo
refero	refero
suffero	suffero
surgo	surgo
volvo	volvo
actus	actus#2	
affectus	affectus#2	
astrum	astrum
bracchium	bracchium
casus	casus#1
cornu	cornu	
cursus	cursus
domus	domus
exercitus	exercitus#3
exitus	exeo	exitus#2
genu	genu
intellectus	intellectus#2	
lumen	lumen
manus	manus#1
motus	motus#2	
occasus	occasus#2
ortus	ortus#3
reditus	reditus
sensus	sensus#2
sidus	sidus
signum	signum
versus	versus#3	
virgo	virgo
visus	visus#2
voluntas	voluntas
aliquis	aliquis
quicumque	quicumque
quidam	quidam
quisquam	quisquam
quisque	quisque
quisquis	quisquis
quivis	quivis
uterque	uter#3
caelestis	caelestis
corporalis	corporalis
cupidus	cupidus
ingens	ingens
naturalis	naturalis
pauci	paucus
proprius	proprius
tardus	tardus
at	at
cum	cum
naturaliter	naturalis
tam	tam
quam	quam	
vero	verus
@Chapter 13
afficio	afficio
agnosco	agnosco
aperio	aperio
deficio	deficio
depono	depono
dispono	dispono
edo	edo#2	
eripio	eripio
excipio	excipio
expono	expono
finio	finio
impero	impero
impono	impono
inquam	inquam
mando	mando#1	
misceo	misceo
nego	nego
odi	odi	
oro	oro
rideo	rideo
specto	specto
suadeo	suadeo
subeo	subeo
uro	uro
coniunx	conjunx
cupido	cupido	
frater	frater
gaudium	gaudium
lacrima	lacrima	
mater	mater
metus	metus
mulier	mulier
munus	munus
osculum	osculum
pietas	pietas#1
potestas	potestas
senectus	senectus#2
soror	soror
thalamus	thalamus
uxor	uxor
aptus	aptus
bellus	bellus
carus	carus#1
crudelis	crudelis
difficilis	difficilis
dissimilis	dissimilis
facilis	facilis
formosus	formosus
gracilis	gracilis
gravis	gravis
humilis	humilis
infinitus	infinitus
levis	levis#1	
natalis	natalis#2
par	par
primus	primus
similis	similis
talis	talis	
tristis	tristis
vicinus	vicinus
adhuc	adhuc
difficile	difficilis
facile	facilis
forte	fors	
protinus	protinus
quam	quam	
semper	semper
tandem	tandem
@Chapter 14
clamo	clamo
cerno	cerno
compono	compono
concedo	concedo
demitto	demitto
dubito	dubito
fio	fio
gaudeo	gaudeo
invideo	invideo
permitto	permitto
posco	posco
taceo	taceo
tango	tango
canis	canis#1	
copia	copia#1	
dies	dies
facies	facies	
fas	fas	
fides	fides#1	
iter	iter	
iuvenis	juvenis
nefas	nefas
res	res
silva	silva
sors	sors
umbra	umbra	
usus	usus#2	
dubius	dubius
mollis	mollis
sacer	sacer
suavis	suavis
quo	quo
@Chapter 15
caveo	
faveo	faveo
defendo	defendo
ignosco	ignosco
inscribo	inscribo
inspicio	inspicio
intro	intro#2
noto	noto	
parco	parco	
pareo	pareo
pendeo	pendeo
persuadeo	persuadeo
pingo	pingo
placeo	placeo
praesto	praesto#2	
servio	servio
amicitia	amicitia
hospes	hospes
inscriptio	inscriptio
libertinus	libertinus#1
limen	limen
pictor	pictor#1
plus	multus
proelium	proelium
saxum	saxum
unda	unda	
voluptas	voluptas
votum	votum	
aureus	aureus
beatus	beo
dives	dives
maior	magnus
maximus	magnus#1	
melior	bonus
minor	minor#2
minimus	parvus
optimus	bonus
pauper	pauper
peior	malus
pessimus	malus
plurimus	multus	
prior	prior
sinister	sinister
summus	superus
supremus	superus
uber	uber#2
denique	denique
diutius	diu
hinc	hinc
illic	illic#2
magis	magnus
magnopere	magnopere
minus	parvus
multum	multus
paene	paene
paulatim	paulatim
plurimum	multus	
plus	multus
primo	primus
quemadmodum	quemadmodum
super	super#2	
@Chapter 16
accedo	accedo
aggredior	aggredior
animadverto	animadverto
audeo	audeo
circumsto	circumsto
conor	conor
destituo	destituo
deterreo	deterreo
egredior	egredior
figo	figo
fruor	fruor
gradior	gradior
hortor	hortor
impedio	impedio
ingredior	ingredior
iuro	juro
loquor	loquor
metuo	metuo
miror	miror
morior	morior	
moror	moror#1	
nascor	nascor
orior	orior
patior	patior
progredior	progredior
prohibeo	prohibeo
sequor	sequor
utor	utor
velo	velo	
vereor	vereor
vulnero	vulnero
adventus	adventus
coniuratus	conjuro
ferrum	ferrum
hostis	hostis	
noxa	noxa
pectus	pectus
saeculum	saeculum
dexter	dexter
fidelis	fidelis
nobilis	nobilis
sceleratus	scelero
singuli	singulus
tutus	tueor
haud	haud
quin	quin
undique	undique
utinam	utinam
donec	donec
etsi	etsi
quin	quin
quominus	
@Lesson 17
accidit	accido#2
arbitror	arbitror
condo	condo	
consto	consto
convenio	convenio
decet	decet
efficio	efficio
evenio	evenio
exsto	exsto
for	for
incolo	incolo#1
iudico	judico
iungo	jungo
libet	libet	
licet	licet
miserat	misero	
oportet	oportet
paenitet	paeniteo
piget	pigeo
praebeo	praebeo
provideo	provideo
pudet	pudeo
taedet	taedet
fatum	fatum	
infans	infer
initium	initium
mille	mille
mons	mons
providentia	providentia
regnum	regnum
status	status#3
victor	victor#1
caecus	caecus#1
centum	centum
decem	decem
diligens	diligens
duo	duo
excellens	excello
maritimus	maritimus
memorabilis	memorabilis
mille	mille
regius	regius
secundus	secundus#1
tres	tres
ultimus	ulter
viginti	viginti
bis	bis
necesse	necesse
semel	semel
ter	ter
dummodo	
dum	dum
modo	modo	
si	si
priusquam	prior
quamquam	quamquam	
quamvis	quamvis
quoniam	quoniam
@Chapter 18
cubo	cubo	
emo	emo
fodio	fodio
habito	habito
ignoro	ignoro
obliviscor	obliviscor
opinor	opinor
vendo	vendo
volito	volito
argentum	argentum
aurum	aurum
campus	campus#3
carmen	carmen#1	
somnus	somnus
somnium	somnium
improbus	improbus
stultus	stultus
vilis	vilis
repente	repens#2
vix	vix
