#Wheelock's Latin (5th Edition)
@Chapter 1
me	ego
quid	quis#1	
amo	amo
cogito	cogito	
conservo	conservo	
debeo	debeo
do	do#1	
erro	erro#1	
laudo	laudo
moneo	moneo
nihil	nihil
non	non
saepe	saepe	
salveo	salveo
servo	servo	
si	si
terreo	terreo	
valeo	valeo
video	video
voco	voco
@Chapter 2
antiquus	antiquus
et	et
est	sum#1
fama	fama
forma	forma	
fortuna	fortuna	
ira	ira
magna	magnus#1
mea	meus
multa	multus
nauta	nauta
o	o
patria	patrius#1	
pecunia	pecunia
philosophia	philosophia
poena	poena
poeta	poeta	
porta	porta	
puella	puella
rosa	rosa
sed	sed
sententia	sententia
sine	sine
tua	tuus
vita	vita
@Chapter 3
ager	ager
agricola	agricola#1
amica	amicus#2
avarus	avarus
de	de#2
femina	femina	
filia	filia
filius	filius
habeo	habeo
hodie	hodie
in	in
numerus	numerus
pauci	paucus
populus	populus#1
puer	puer
Romanus	Romanus
sapientia	sapientia	
satio	satio#1	
semper	semper
vir	vir
@Chapter 4
basium	basium
bellum	bellum	
bellus	bellus
bonus	bonus
consilium	consilium
cura	cura	
donum	donum
exitium	exitium
humanus	humanus
iuvo	juvo
magister	magister
magistra	magistra	
malus	malus#1	
mora	mora#1	
nihil	nihil
oculus	oculus
officium	officium
otium	otium
parvus	parvus
periculum	periculum
remedium	remedium
stultus	stultus
sum	sum#1
verus	verus
@Chapter 5
adulescentia	adulescentia
animus	animus
caelum	caelum#2
culpa	culpa	
culpo	culpo
gloria	gloria	
igitur	igitur
liber	liber#2	
maneo	maneo
noster	noster
propter	propter
pulcher	pulcher#1
quando	quando
remaneo	remaneo
sanus	sanus
satis	satis
supero	supero	
tum	tum
verbum	verbum
@Chapter 6
deus	deus
discipula	discipula
discipulus	discipulus
Graecus	Graecus
ibi	ibi
insidiae	insidiae
liber	liber#4	
nunc	nunc
perpetuus	perpetuus
quare	quare
plenus	plenus
possum	possum
salvus	salvus
secundus	secundus#1
tolero	tolero
sed	sed
tyrannus	tyrannus
ubi	ubi
vester	vester
vitium	vitium
@Chapter 7
amor	amor
audeo	audeo
carmen	carmen#1	
civitas	civitas
corpus	corpus
homo	homo
labor	labor#2
littera	littera
mos	mos
neco	neco
nomen	nomen
novus	novus
pax	pax
post	post
regina	regina
rex	rex
sub	sub
tempus	tempus
terra	terra
uxor	uxor
virgo	virgo
virtus	virtus
@Chapter 8
ad	ad
ago	ago
copia	copia#1	
demonstro	demonstro
disco	disco	
doceo	doceo
duco	duco
dum	dum
ex	ex
frater	frater
gero	gero#1	
gratias	gratia
laus	laus
libertas	libertas	
numquam	numquam
ratio	ratio
scribo	scribo
scriptor	scriptor
soror	soror
tamen	tamen
traho	traho
victoria	victoria
vinco	vinco
@Chapter 9
alius	alius#2
alter	alter	
enim	enim
hic	hic
ille	ille
in	in
iste	iste
locus	locus
morbus	morbus
neuter	neuter
nimis	nimis
nullus	nullus
solus	solus#1
studium	studium
totus	totus#1	
ullus	ullus
unus	unus
uter	uter#3
@Chapter 10
amicitia	amicitia
audio	audio
beatus	beo
capio	capio#1
cum	cum
cupiditas	cupiditas
dico	dico#2
facio	facio
fugio	fugio
hora	hora#1
invenio	invenio
natura	natura
quoniam	quoniam
senectus	senectus#2
timor	timor
venio	venio
veritas	veritas
via	via	
vivo	vivo	
voluptas	voluptas
@Chapter 11
amicus	amicus#2
autem	autem
bene	bene	
caput	caput
carus	carus#1
consul	consul
ego	ego
etiam	etiam
idem	idem
intellego	intellego
is	is
mitto	mitto
nec	neque
nemo	nemo
neque	neque
nos	nos	
quod	qui#1
sentio	sentio
tu	tu
vos	tu
@Chapter 12
acerbus	acerbus
adulescens	adulescens
amitto	amitto
annus	annus
Asia	Asia#1	
Caesar	Caesar
cado	cado	
creo	creo
diu	diu
mater	mater
medica	medica#2	
medicus	medicus#1
nuper	nuper
pater	pater
patientia	patientia	
principium	principium
pro	pro#1	
senex	senex
@Chapter 13
alo	alo
ante	ante
diligo	diligo
divitiae	divitiae
doctus	doceo
factum	facio	
fortunatus	fortuno
ipse	ipse
iungo	jungo
nam	nam
olim	olim
per	per
quisque	quisque
signum	signum
sto	sto
sui	sui
suus	suus
@Chapter 14
animal	animal
appello	appello#1
aqua	aqua
ars	ars
auris	auris	
civis	civis
curro	curro
ius	jus
mare	mare
mors	mors
muto	muto#2	
nubes	nubes	
os	os#1	
pars	pars
Roma	Roma
teneo	teneo
trans	trans
turba	turbo#1
urbs	urbs
vis	vis	
vito	vito
@Chapter 15
Italia	Italia
committo	committo
timeo	timeo
tempestas	tempestas
eicio	eicio
exspecto	exspecto
iacio	jacio
inter	inter
itaque	ita	
memoria	memoria
miser	miser
nonaginta	nonaginta
mille	mille
nongenti	nongenti
novem	novo
octavus	octavus
octingenti	octingenti
octo	octo
octoginta	octoginta
quadraginta	quadraginta
quadringenti	quadringenti
quartus	quartus
quaterni	quaterni
quattuor	quattuor
quattuordecim	
quindecim	
quingenti	quingenti
quinquaginta	quinquaginta
quinque	quin
quintus	quintus#1
sedecim	
septem	septem
septendecim	
septimus	septimus
septingenti	septingenti
septuaginta	septuaginta
sescenti	sescenti
sex	sex
sexaginta	sexa_ginta
sextus	sextus#1
tertius	tertius
trecenti	trecenti
tredecim	
tres	tres
triginta	triginta
undecim	undecim
undecimus	undecimus
viginti	viginti
centum	centum
decimus	decimus#1
duo	duo
duodecim	
duodecimus	duodecimus
duodeviginti	
@Chapter 16
acer	acer#2
aetas	aetas
auditor	auditor
brevis	brevis
celer	celer#1	
clementia	clementia
difficilis	difficilis
dulcis	dulcis
facilis	facilis
facio	facio
fortis	fortis
ingens	ingens
iucundus	jucundus
longus	longus
mens	mens
omnis	omnis
potens	possum	
quam	quam	
rego	rego
satura	satur	
@Chapter 17
admitto	admitto
aut	aut
caecus	caecus#1
cito	cieo	
coepi	coepio
cupio	cupio
deleo	deleo
desidero	desidero
incipio	incipio
levis	levis#1	
libellus	libellus
navigo	navigo
neglego	neglego
quoque	quo
qui	qui#1	
recito	recito
@Chapter 18
ab	ab
clarus	clarus
cras	cras	
cur	cur
deinde	deinde
flumen	flumen
fluo	fluo
genus	genu	
heri	heri
hostis	hostis	
lego	lego#1	
ludus	ludus
misceo	misceo
mortalis	mortalis
moveo	moveo
probitas	probitas	
scientia	scientia	
videor	video
@Chapter 19
argumentum	argumentum
at	at
auctor	auctor
beneficium	beneficium
certus	certus
contra	contra
delecto	delecto	
familia	familia
Graecia	Graecia
gravis	gravis
iam	jam
immortalis	immortalis
iudex	judex
iudicium	judicium
libero	libero
paro	paro#1	
qui	qui#1	
nisi	nisi	
scelus	scelus
quis	quis#1	
@Chapter 20
careo	careo	
communis	communis
coniuratus	conjuro
cornu	cornu	
defendo	defendo
discedo	discedo
dexter	dexter
fructus	fructus#2	
genu	genu
manus	manus#1
metus	metus
mons	mons
odi	odi	
prohibeo	prohibeo
pronuntio	pronuntio
senatus	senatus
sensus	sensus#2	
servitus	servitus
sinister	sinister
spiritus	spiritus
versus	versus#3	
@Chapter 21
ac	atque
asper	asper#1
atque	atque
casa	casa
causa	causa
contineo	contineo
fenestra	fenestra	
finis	finis
gens	gens
iterum	iterum
iubeo	jubeo
laboro	laboro
mundus	mundus#2
navis	navis	
rapio	rapio
relinquo	relinquo
salus	salus
scio	scio	
Troia	Troja
tango	tango
vicinus	vicinus
vulgus	vulgus
@Chapter 22
aequus	aequus
cerno	cerno
dies	dies
eripio	eripio
felix	felix#1	
ferrum	ferrum
fides	fides#1	
ignis	ignis
incertus	incertus
Latinus	Latinus	
inquit	inquam
medius	medius
modus	modus
protinus	protinus
quondam	quondam
res	res
!res publica	reor	res
spes	spes
tollo	tollo
ultra	ultra
@Chapter 23
aliquis	aliquis
arx	arx
averto	averto
dux	dux
educo	educo#1	
equus	equus#1
gaudeo	gaudeo
hasta	hasta
insula	insula#1
litus	litus#3
magnanimus	magnanimus
miles	miles	
opprimo	opprimo
orator	orator
ostendo	ostendo
premo	premo
peto	peto
quisquis	quisquis
sacerdos	sacerdos#1
umquam	umquam
verto	verto
@Chapter 24
Carthago	Carthago#1	
accipio	accipio
excipio	excipio
expello	expello
fabula	fabula#1
imperator	imperator
imperium	imperium
narro	narro
pello	pello
perfugium	perfugium
postea	postea
quaero	quaero
recipio	recipio
rideo	rideo
servus	servus#2
solacium	solacium
vulnus	vulnus
ut	ut
@Chapter 25
ait	aio
credo	credo
dehinc	dehinc
ferox	ferox
fidelis	fidelis
geminus	geminus
iaceo	jaceo
lingua	lingua
nego	nego
nescio	nescio	
nuntio	nuntio	
patefacio	patefacio
puto	puto	
sapiens	sapio
spero	spero
suscipio	suscipio
ultimus	ulter
@Chapter 26
cena	cena	
forum	forum#1	
invito	invito	
lex	lex
limen	limen
lux	lux
nox	nox
prae	prae
pudicus	pudicus
quam	quam	
quiddam	quidam
somnus	somnus
superbus	superbus
tantum	tantus
tristis	tristis
turpis	turpis
urbanus	urbanus
@Chapter 27
delectatio	delectatio
diligens	diligens
dissimilis	dissimilis
gracilis	gracilis
humilis	humilis
maiores	magnus
nepos	nepos#1
pono	pono
primus	primus
probo	probo	
quot	quot
similis	similis
sol	sol
superus	superus
utilis	utilis
@Chapter 28
arma	arma
cedo	cedo#1
cursus	cursus
dedico	dedico
egeo	egeo
expleo	expleo
luna	luna#1	
mortuus	morior
ne	ne#1	
occasio	occasio
parens	parens#2
praesto	praesto#2	
princeps	princeps
stella	stella	
taceo	taceo
ut	ut
vesper	vesper
@Chapter 29
condo	condo	
contendo	contendo
denique	denique
dignus	dignus
durus	durus
fatum	fatum	
ingenium	ingenium
ita	ita	
moenia	moenia#1
mollio	mollio
nata	nascor
osculum	osculum
pugno	pugno	
quidem	quidem
respondeo	respondeo
sic	sic
sidus	sidus
surgo	surgo
tam	tam
tantus	tantus
vero	verus
@Chapter 30
an	an
bibo	bibo#1	
ceteri	ceterus
cognosco	cognosco
comprehendo	comprehendo
consumo	consumo
dubito	dubito
expono	expono
furtim	furtim
honor	honor
mensa	mensa
minuo	minuo
mox	mox
primo	primus
quantus	quantus
rogo	rogo
repente	repens#2
ridiculus	ridiculus
unde	unde
utrum	utrum
vivus	vivus
@Chapter 31
affero	affero
apud	apud
as	
auxilium	auxilium
confero	confero
cum	cum
digitus	digitus#1
doleo	doleo
dormio	dormio
elephantus	
exsilium	exsilium
fero	fero	
invideo	invideo
invidia	invidia
mediocris	mediocris
occido	occido#1
offero	offertor
refero	refero
rumor	rumor
semel	semel
usque	usque
vinum	vinum
@Chapter 32
custodia	custodia
dives	dives
dummodo	
exercitus	exercitus#2
malo	malo	
nolo	nolo
par	par
pateo	pateo
pauper	pauper
paupertas	paupertas
praebeo	praebeo
promitto	promitto
volo	volo#1	
@Chapter 33
candidus	candidus
heu	heu
initium	initium
merus	merus
ops	ops#1
philosophus	philosophus
plebs	plebs
quis	quis#1	
recuso	recuso
sal	
speculum	speculum
suavis	suavis
subito	subeo	
trado	trado
@Chapter 34
adversus	adversus
anima	anima	
arbitror	arbitror
conor	conor
cresco	cresco
egredior	egredior
fateor	fateor
hortor	hortor
loquor	loquor
molior	molior
morior	morior	
nascor	nascor
patior	patior
proficiscor	proficiscor
remissio	remissio
rusticor	rusticor
sedeo	sedeo
sequor	sequor
specto	specto
talis	talis	
utor	utor
vae	vae
vox	vox
@Chapter 35
aestas	aestas
antepono	antepono
foveo	foveo
ianua	janua
ignosco	ignosco
impero	impero
iratus	irascor
miror	miror
noceo	noceo
nubo	nubo
parco	parco
pareo	pareo
persuadeo	persuadeo
placeo	placeo
pectus	pectus
praemium	praemium
sapio	sapio
servio	servio
studeo	studeo
subrideo	sub-rideo
@Chapter 36
accedo	accedo
carpo	carpo
cogo	cogo
contemno	contemno
contundo	contundo
cotidie	cottidie
cupido	cupido	
curo	curo
decerno	decerno
exigo	exigo
fio	fio
fortasse	fortasse
lector	lector
oblecto	oblecto
oro	oro
recreo	recreo
requiro	requiro
sereno	sereno	
vinculum	vinculum
@Chapter 37
Athenae	Athenae
abeo	abeo
absens	absum
adeo	adeo#1	
domus	domus
eo	eo#1	
exeo	exeo
foris	foris#2	
gratus	gratus
humus	humus
idoneus	idoneus
immotus	immotus
ineo	ineo
interficio	interficio
iter	iter	
licet	licet
obeo	obeo
peregrinor	peregrinor
pereo	pereo
redeo	redeo
requiesco	requiesco
rus	rus
soleo	soleo
Syracusae	Syracusae
@Chapter 38
arbor	arbor#1
dignitas	dignitas
dolor	dolor
erga	erga
etsi	etsi
firmus	firmus
impedio	impedio
infirmus	infirmus
libenter	libet
metuo	metuo
mirabilis	mirabilis
odium	odium#1	
opus	opus#1
oratio	oratio
pes	pes
pristinus	pristinus#1	
queror	queror
recognosco	recognosco
sator	sator
sublimis	sublimis
suspendo	suspendo
vendo	vendo
@Chapter 39
aedificium	aedificium
ambulo	ambulo
cupidus	cupidus
experior	experior
iniuria	injuria	
liberalis	liberalis#1
libo	libo#2
mulier	mulier
necesse	necesse
oportet	oportet
oppugno	oppugno#1
orno	orno	
pernocto	pernocto
quasi	quasi
transeo	transeo
transitus	transitus#2
vetus	vetus
ventus	ventus
@Chapter 40
aes	aes
domina	domina
dominus	dominus
explico	explico
fatigo	fatigo
for	for
iustus	justus
lacrima	lacrima	
meta	meta	
monumentum	monumentum
nasus	nasus#1
nonne	nonne	
num	num	
omnino	omnino
opinor	opinor
postremum	posterus
praeter	praeter
quin	quin
reperio	reperio
saxum	saxum
tot	tot
vereor	vereor
vultus	vultus
